GEOID,Census Tract,County,ttl_nrE,ttl_nrM,undrg_E,undrg_M,grd_ppE,grd_ppM,totalenrol,totalenr_1,difference
24031700310,Census Tract 7003.10, Montgomery County,1439,346,413,165,106,87,519,682,-163
24047950000,Census Tract 9500, Worcester County,131,103,63,61,0,12,63,12,51
24005408601,Census Tract 4086.01, Baltimore County,1067,133,156,63,44,37,200,304,-104
24005490703,Census Tract 4907.03, Baltimore County,829,207,144,78,129,88,273,361,-88
24033806602,Census Tract 8066.02, Prince George's County,1380,289,96,77,82,59,178,615,-437
24510260202,Census Tract 2602.02, Baltimore city,1298,382,184,126,30,52,214,397,-183
24005430104,Census Tract 4301.04, Baltimore County,416,124,106,51,28,34,134,151,-17
24510150100,Census Tract 1501, Baltimore city,431,182,57,55,9,16,66,106,-40
24510250303,Census Tract 2503.03, Baltimore city,389,144,44,29,0,12,44,34,10
24510180100,Census Tract 1801, Baltimore city,740,213,113,74,0,12,113,113,0
24031701422,Census Tract 7014.22, Montgomery County,1114,212,263,111,102,64,365,403,-38
24043000400,Census Tract 4, Washington County,299,76,81,44,0,12,81,103,-22
24510020300,Census Tract 203, Baltimore city,377,140,81,55,188,92,269,414,-145
24005491000,Census Tract 4910, Baltimore County,707,83,45,28,33,21,78,53,25
24510250402,Census Tract 2504.02, Baltimore city,1358,307,114,89,5,9,119,348,-229
24003750203,Census Tract 7502.03, Anne Arundel County,350,77,52,36,0,12,52,92,-40
24031701218,Census Tract 7012.18, Montgomery County,402,139,74,53,51,32,125,184,-59
24005404102,Census Tract 4041.02, Baltimore County,1055,276,89,78,53,64,142,503,-361
24005452500,Census Tract 4525, Baltimore County,1110,255,253,140,33,30,286,178,108
24510150600,Census Tract 1506, Baltimore city,761,358,242,171,39,40,281,213,68
24033806708,Census Tract 8067.08, Prince George's County,1044,238,113,80,187,103,300,578,-278
24031703302,Census Tract 7033.02, Montgomery County,1000,203,256,131,21,25,277,290,-13
24005408800,Census Tract 4088, Baltimore County,681,138,51,37,66,46,117,202,-85
24005450400,Census Tract 4504, Baltimore County,445,88,73,37,9,13,82,92,-10
24510260102,Census Tract 2601.02, Baltimore city,1221,263,188,121,81,81,269,445,-176
24033802107,Census Tract 8021.07, Prince George's County,1028,196,148,71,45,33,193,208,-15
24510151100,Census Tract 1511, Baltimore city,2062,742,686,301,49,56,735,394,341
24031701210,Census Tract 7012.10, Montgomery County,1126,145,138,89,17,17,155,157,-2
24510270703,Census Tract 2707.03, Baltimore city,573,206,132,121,46,35,178,151,27
24510130804,Census Tract 1308.04, Baltimore city,353,103,66,35,86,37,152,205,-53
24510250102,Census Tract 2501.02, Baltimore city,682,225,169,119,90,85,259,434,-175
24031705901,Census Tract 7059.01, Montgomery County,1220,213,58,37,35,27,93,189,-96
24510120100,Census Tract 1201, Baltimore city,1512,463,516,236,588,262,1104,1038,66
24510250205,Census Tract 2502.05, Baltimore city,1125,368,73,65,43,42,116,263,-147
24033803402,Census Tract 8034.02, Prince George's County,1078,308,196,95,18,20,214,235,-21
24510151000,Census Tract 1510, Baltimore city,851,269,181,108,92,97,273,187,86
24005420200,Census Tract 4202, Baltimore County,566,152,121,72,25,24,146,46,100
24031704805,Census Tract 7048.05, Montgomery County,357,101,53,31,109,56,162,135,27
24510180300,Census Tract 1803, Baltimore city,362,80,51,39,152,47,203,312,-109
24033800520,Census Tract 8005.20, Prince George's County,516,180,171,62,78,53,249,83,166
24005400900,Census Tract 4009, Baltimore County,479,114,27,21,15,18,42,125,-83
24510170200,Census Tract 1702, Baltimore city,930,271,77,55,7,11,84,191,-107
24510140300,Census Tract 1403, Baltimore city,441,187,109,63,17,14,126,162,-36
24027605504,Census Tract 6055.04, Howard County,892,110,183,88,75,46,258,152,106
24033800210,Census Tract 8002.10, Prince George's County,800,235,153,104,77,53,230,285,-55
24017850905,Census Tract 8509.05, Charles County,1287,192,387,141,126,62,513,467,46
24031700706,Census Tract 7007.06, Montgomery County,1082,160,121,62,108,72,229,197,32
24510270101,Census Tract 2701.01, Baltimore city,468,163,14,19,87,81,101,130,-29
24031701005,Census Tract 7010.05, Montgomery County,708,129,96,50,35,29,131,344,-213
24019970900,Census Tract 9709, Dorchester County,135,46,23,21,0,12,23,51,-28
24031701001,Census Tract 7010.01, Montgomery County,1105,325,297,174,7,10,304,397,-93
24510080400,Census Tract 804, Baltimore city,206,102,12,17,12,17,24,10,14
24510260303,Census Tract 2603.03, Baltimore city,213,87,45,39,7,10,52,19,33
24031702800,Census Tract 7028, Montgomery County,1159,218,228,110,259,154,487,351,136
24033801211,Census Tract 8012.11, Prince George's County,750,315,85,53,45,52,130,282,-152
24033801307,Census Tract 8013.07, Prince George's County,641,144,147,74,67,39,214,291,-77
24033803001,Census Tract 8030.01, Prince George's County,471,181,126,66,60,51,186,177,9
24005411408,Census Tract 4114.08, Baltimore County,877,175,142,76,132,65,274,338,-64
24005980100,Census Tract 9801, Baltimore County,0,12,0,12,0,12,0,0,0
24510280402,Census Tract 2804.02, Baltimore city,367,123,77,56,14,15,91,189,-98
24031700828,Census Tract 7008.28, Montgomery County,584,75,101,44,36,23,137,162,-25
24005420800,Census Tract 4208, Baltimore County,601,178,78,49,25,28,103,267,-164
24003730204,Census Tract 7302.04, Anne Arundel County,1860,331,199,90,52,44,251,373,-122
24047950600,Census Tract 9506, Worcester County,460,96,90,76,18,20,108,174,-66
24027606607,Census Tract 6066.07, Howard County,1372,230,210,98,119,67,329,317,12
24510020100,Census Tract 201, Baltimore city,218,54,37,23,94,46,131,256,-125
24001001402,Census Tract 14.02, Allegany County,234,57,36,25,0,12,36,60,-24
24005490200,Census Tract 4902, Baltimore County,711,152,113,51,25,31,138,259,-121
24033805906,Census Tract 8059.06, Prince George's County,974,222,156,90,80,55,236,149,87
24510271101,Census Tract 2711.01, Baltimore city,540,138,219,123,90,48,309,213,96
24510160100,Census Tract 1601, Baltimore city,515,241,40,63,13,21,53,76,-23
24033806501,Census Tract 8065.01, Prince George's County,1434,250,180,92,61,48,241,169,72
24510230100,Census Tract 2301, Baltimore city,416,130,38,34,114,64,152,163,-11
24031704503,Census Tract 7045.03, Montgomery County,1216,159,114,59,22,27,136,219,-83
24033805908,Census Tract 8059.08, Prince George's County,573,139,150,62,76,41,226,453,-227
24047950400,Census Tract 9504, Worcester County,705,113,93,55,20,22,113,94,19
24047980000,Census Tract 9800, Worcester County,0,12,0,12,0,12,0,0,0
24005490603,Census Tract 4906.03, Baltimore County,609,93,127,50,19,22,146,200,-54
24031705602,Census Tract 7056.02, Montgomery County,763,219,134,109,153,86,287,469,-182
24033806900,Census Tract 8069, Prince George's County,1223,329,209,130,148,94,357,814,-457
24027606704,Census Tract 6067.04, Howard County,1771,282,283,158,271,108,554,670,-116
24033801408,Census Tract 8014.08, Prince George's County,704,182,135,90,43,63,178,147,31
24510020200,Census Tract 202, Baltimore city,392,90,63,30,206,60,269,327,-58
24005400200,Census Tract 4002, Baltimore County,585,162,230,85,64,55,294,245,49
24031700835,Census Tract 7008.35, Montgomery County,1438,226,454,118,179,80,633,365,268
24033801209,Census Tract 8012.09, Prince George's County,1355,270,385,113,60,57,445,480,-35
24510100300,Census Tract 1003, Baltimore city,357,205,83,79,0,12,83,37,46
24510030100,Census Tract 301, Baltimore city,547,190,28,31,8,13,36,204,-168
24033802404,Census Tract 8024.04, Prince George's County,1202,324,129,80,25,30,154,200,-46
24033806711,Census Tract 8067.11, Prince George's County,1569,391,340,163,167,93,507,331,176
24031701313,Census Tract 7013.13, Montgomery County,975,131,280,89,58,42,338,274,64
24005402404,Census Tract 4024.04, Baltimore County,1225,290,149,91,99,105,248,579,-331
24033801308,Census Tract 8013.08, Prince George's County,946,270,347,158,119,89,466,330,136
24031700724,Census Tract 7007.24, Montgomery County,1029,237,187,95,80,68,267,332,-65
24510120201,Census Tract 1202.01, Baltimore city,704,178,323,143,133,46,456,295,161
24510270501,Census Tract 2705.01, Baltimore city,807,195,115,90,78,58,193,181,12
24510270902,Census Tract 2709.02, Baltimore city,2148,452,1445,349,103,63,1548,1958,-410
24031703601,Census Tract 7036.01, Montgomery County,1093,175,215,102,105,70,320,292,28
24027601203,Census Tract 6012.03, Howard County,1572,294,139,72,249,106,388,333,55
24027605401,Census Tract 6054.01, Howard County,1361,290,196,139,99,66,295,476,-181
24510271503,Census Tract 2715.03, Baltimore city,64,25,20,18,4,7,24,43,-19
24510280500,Census Tract 2805, Baltimore city,643,116,68,77,0,12,68,267,-199
24510070300,Census Tract 703, Baltimore city,173,98,36,33,0,12,36,38,-2
24021751001,Census Tract 7510.01, Frederick County,294,70,93,40,9,14,102,121,-19
24510271802,Census Tract 2718.02, Baltimore city,420,142,36,31,17,26,53,151,-98
24510010200,Census Tract 102, Baltimore city,444,120,68,38,181,71,249,250,-1
24031701420,Census Tract 7014.20, Montgomery County,1198,294,463,152,40,41,503,306,197
24003731004,Census Tract 7310.04, Anne Arundel County,1103,165,82,59,169,82,251,314,-63
24005408602,Census Tract 4086.02, Baltimore County,479,63,64,26,36,20,100,104,-4
24005420702,Census Tract 4207.02, Baltimore County,550,145,139,60,18,16,157,91,66
24005490602,Census Tract 4906.02, Baltimore County,906,120,232,98,66,40,298,446,-148
24003750202,Census Tract 7502.02, Anne Arundel County,852,188,254,129,28,32,282,143,139
24510130100,Census Tract 1301, Baltimore city,640,218,226,112,42,49,268,233,35
24031701216,Census Tract 7012.16, Montgomery County,557,172,50,58,207,120,257,248,9
24005401503,Census Tract 4015.03, Baltimore County,1348,198,256,111,66,62,322,405,-83
24045010102,Census Tract 101.02, Wicomico County,801,245,270,133,81,60,351,410,-59
24013507601,Census Tract 5076.01, Carroll County,1115,189,159,57,88,68,247,562,-315
24005491900,Census Tract 4919, Baltimore County,306,84,57,39,12,15,69,121,-52
24033803526,Census Tract 8035.26, Prince George's County,567,187,146,111,51,40,197,159,38
24031701602,Census Tract 7016.02, Montgomery County,2482,352,371,140,101,78,472,611,-139
24005408704,Census Tract 4087.04, Baltimore County,1416,235,215,103,119,81,334,444,-110
24005450501,Census Tract 4505.01, Baltimore County,817,233,283,120,0,12,283,146,137
24005440300,Census Tract 4403, Baltimore County,509,131,89,55,40,27,129,218,-89
24027605601,Census Tract 6056.01, Howard County,2173,529,445,180,318,144,763,932,-169
24510270801,Census Tract 2708.01, Baltimore city,1221,270,288,126,112,66,400,389,11
24045010800,Census Tract 108, Wicomico County,1272,329,337,142,35,40,372,582,-210
24510150400,Census Tract 1504, Baltimore city,1261,305,796,218,19,24,815,896,-81
24047951400,Census Tract 9514, Worcester County,578,114,83,62,10,17,93,166,-73
24005490302,Census Tract 4903.02, Baltimore County,2379,383,1929,341,116,62,2045,1949,96
24019970804,Census Tract 9708.04, Dorchester County,383,109,42,27,18,28,60,89,-29
24027606803,Census Tract 6068.03, Howard County,1285,288,111,63,110,82,221,559,-338
24031700308,Census Tract 7003.08, Montgomery County,1569,369,346,180,75,70,421,401,20
24510170300,Census Tract 1703, Baltimore city,501,154,120,82,54,47,174,112,62
24031700834,Census Tract 7008.34, Montgomery County,1340,225,183,84,56,41,239,558,-319
24043000500,Census Tract 5, Washington County,1805,388,270,212,46,72,316,289,27
24021751002,Census Tract 7510.02, Frederick County,1174,233,251,132,115,116,366,251,115
24021750504,Census Tract 7505.04, Frederick County,1328,409,260,146,95,111,355,554,-199
24033800109,Census Tract 8001.09, Prince George's County,833,253,152,92,43,35,195,200,-5
24033802106,Census Tract 8021.06, Prince George's County,1045,225,205,92,49,45,254,166,88
24510250401,Census Tract 2504.01, Baltimore city,920,297,179,106,46,73,225,204,21
24005420701,Census Tract 4207.01, Baltimore County,736,241,116,64,29,29,145,225,-80
24510160200,Census Tract 1602, Baltimore city,730,195,73,54,0,12,73,143,-70
24017990000,Census Tract 9900, Charles County,0,12,0,12,0,12,0,0,0
24005430200,Census Tract 4302, Baltimore County,690,147,152,91,10,15,162,312,-150
24510200500,Census Tract 2005, Baltimore city,516,183,36,35,0,12,36,50,-14
24031701102,Census Tract 7011.02, Montgomery County,1450,309,274,133,116,73,390,339,51
24005401505,Census Tract 4015.05, Baltimore County,963,163,266,109,89,64,355,294,61
24031705100,Census Tract 7051, Montgomery County,1282,129,75,34,87,42,162,158,4
24031700901,Census Tract 7009.01, Montgomery County,704,199,203,97,166,140,369,365,4
24003701200,Census Tract 7012, Anne Arundel County,1877,353,260,195,98,83,358,660,-302
24031700820,Census Tract 7008.20, Montgomery County,764,129,170,60,29,29,199,242,-43
24510272004,Census Tract 2720.04, Baltimore city,914,257,305,213,179,75,484,572,-88
24031703219,Census Tract 7032.19, Montgomery County,45,41,30,33,0,12,30,0,30
24033805500,Census Tract 8055, Prince George's County,842,236,83,53,50,54,133,246,-113
24033803002,Census Tract 8030.02, Prince George's County,689,179,62,62,66,62,128,90,38
24005430400,Census Tract 4304, Baltimore County,1127,208,346,134,83,40,429,407,22
24005403500,Census Tract 4035, Baltimore County,1511,143,156,61,163,66,319,293,26
24031700718,Census Tract 7007.18, Montgomery County,1158,247,418,185,196,92,614,356,258
24510270102,Census Tract 2701.02, Baltimore city,676,211,112,87,94,69,206,212,-6
24005492401,Census Tract 4924.01, Baltimore County,917,129,141,80,42,28,183,310,-127
24033804700,Census Tract 8047, Prince George's County,794,195,288,106,87,72,375,215,160
24003730603,Census Tract 7306.03, Anne Arundel County,944,178,156,61,10,17,166,218,-52
24003740303,Census Tract 7403.03, Anne Arundel County,927,138,178,71,33,34,211,232,-21
24005404501,Census Tract 4045.01, Baltimore County,1829,239,230,132,121,92,351,558,-207
24510260301,Census Tract 2603.01, Baltimore city,1301,367,181,101,0,12,181,199,-18
24033803524,Census Tract 8035.24, Prince George's County,1523,279,157,79,111,80,268,360,-92
24003730506,Census Tract 7305.06, Anne Arundel County,714,241,71,58,21,28,92,486,-394
24510230200,Census Tract 2302, Baltimore city,314,146,87,97,143,105,230,201,29
24510261100,Census Tract 2611, Baltimore city,201,57,31,15,110,49,141,167,-26
24510060400,Census Tract 604, Baltimore city,464,133,51,40,248,90,299,168,131
24031706012,Census Tract 7060.12, Montgomery County,623,156,81,40,69,45,150,178,-28
24031704803,Census Tract 7048.03, Montgomery County,845,188,77,76,295,125,372,301,71
24510090800,Census Tract 908, Baltimore city,469,181,78,53,21,32,99,136,-37
24005401101,Census Tract 4011.01, Baltimore County,1401,442,556,185,110,92,666,730,-64
24027606705,Census Tract 6067.05, Howard County,461,75,127,48,42,25,169,199,-30
24510200400,Census Tract 2004, Baltimore city,374,100,17,20,0,12,17,54,-37
24021750100,Census Tract 7501, Frederick County,192,57,26,24,36,26,62,81,-19
24027602303,Census Tract 6023.03, Howard County,1013,99,106,59,33,29,139,213,-74
24005402505,Census Tract 4025.05, Baltimore County,916,238,244,121,21,27,265,189,76
24033803612,Census Tract 8036.12, Prince George's County,872,220,226,164,39,38,265,267,-2
24005440702,Census Tract 4407.02, Baltimore County,1245,469,371,254,66,70,437,459,-22
24033800402,Census Tract 8004.02, Prince George's County,1035,158,175,95,99,52,274,311,-37
24510070100,Census Tract 701, Baltimore city,756,185,22,23,44,42,66,140,-74
24510271102,Census Tract 2711.02, Baltimore city,3738,490,3333,493,120,60,3453,3327,126
24510160500,Census Tract 1605, Baltimore city,858,239,136,75,0,12,136,221,-85
24005441102,Census Tract 4411.02, Baltimore County,1120,258,290,133,16,24,306,398,-92
24005403100,Census Tract 4031, Baltimore County,439,92,75,48,32,30,107,96,11
24005491300,Census Tract 4913, Baltimore County,1171,213,566,193,104,69,670,735,-65
24003730300,Census Tract 7303, Anne Arundel County,913,230,194,92,23,29,217,252,-35
24031701601,Census Tract 7016.01, Montgomery County,707,151,191,104,51,36,242,286,-44
24033802600,Census Tract 8026, Prince George's County,732,198,122,63,21,20,143,98,45
24021750801,Census Tract 7508.01, Frederick County,660,127,191,113,83,60,274,375,-101
24033800412,Census Tract 8004.12, Prince George's County,1153,208,243,205,71,43,314,307,7
24005408503,Census Tract 4085.03, Baltimore County,882,183,169,106,31,28,200,302,-102
24510280200,Census Tract 2802, Baltimore city,1168,276,361,157,139,99,500,305,195
24001000700,Census Tract 7, Allegany County,861,245,175,92,27,38,202,144,58
24025301105,Census Tract 3011.05, Harford County,948,154,173,82,85,73,258,415,-157
24033804801,Census Tract 8048.01, Prince George's County,533,190,120,108,71,50,191,321,-130
24033801802,Census Tract 8018.02, Prince George's County,708,236,130,91,28,28,158,204,-46
24510060200,Census Tract 602, Baltimore city,681,190,83,49,51,40,134,221,-87
24017850901,Census Tract 8509.01, Charles County,1395,234,166,100,73,71,239,237,2
24510200300,Census Tract 2003, Baltimore city,282,123,25,28,0,12,25,43,-18
24003750102,Census Tract 7501.02, Anne Arundel County,616,165,87,45,0,12,87,86,1
24003750300,Census Tract 7503, Anne Arundel County,777,291,206,109,37,41,243,186,57
24043000200,Census Tract 2, Washington County,851,166,199,89,62,42,261,193,68
24047951200,Census Tract 9512, Worcester County,959,281,272,126,29,32,301,128,173
24510130803,Census Tract 1308.03, Baltimore city,557,156,154,86,134,97,288,155,133
24005420500,Census Tract 4205, Baltimore County,538,144,82,52,83,66,165,189,-24
24510190100,Census Tract 1901, Baltimore city,589,192,15,12,8,9,23,71,-48
24005411303,Census Tract 4113.03, Baltimore County,1379,421,365,161,90,67,455,409,46
24510120700,Census Tract 1207, Baltimore city,408,143,97,61,94,43,191,365,-174
24510270402,Census Tract 2704.02, Baltimore city,1092,270,172,105,17,20,189,225,-36
24039930102,Census Tract 9301.02, Somerset County,685,186,163,104,14,22,177,114,63
24039930200,Census Tract 9302, Somerset County,226,71,42,32,7,10,49,34,15
24031700832,Census Tract 7008.32, Montgomery County,1099,154,224,69,44,27,268,195,73
24033805802,Census Tract 8058.02, Prince George's County,967,182,93,53,39,30,132,221,-89
24031701418,Census Tract 7014.18, Montgomery County,1228,189,271,113,81,54,352,318,34
24510260900,Census Tract 2609, Baltimore city,591,221,25,22,267,141,292,136,156
24510150300,Census Tract 1503, Baltimore city,332,139,99,72,0,12,99,131,-32
24043000100,Census Tract 1, Washington County,856,169,91,59,20,23,111,108,3
24510260403,Census Tract 2604.03, Baltimore city,463,191,19,23,0,12,19,159,-140
24510260604,Census Tract 2606.04, Baltimore city,606,145,92,63,24,26,116,70,46
24005490605,Census Tract 4906.05, Baltimore County,5002,598,4922,601,19,23,4941,4715,226
24510200702,Census Tract 2007.02, Baltimore city,286,184,67,79,6,10,73,51,22
24510080302,Census Tract 803.02, Baltimore city,763,208,29,33,62,61,91,37,54
24003730402,Census Tract 7304.02, Anne Arundel County,1019,295,187,114,131,99,318,218,100
24003730502,Census Tract 7305.02, Anne Arundel County,1852,413,372,164,90,83,462,558,-96
24005490601,Census Tract 4906.01, Baltimore County,641,88,46,33,51,34,97,108,-11
24033803523,Census Tract 8035.23, Prince George's County,913,207,294,118,75,36,369,509,-140
24510260101,Census Tract 2601.01, Baltimore city,1377,351,178,85,114,61,292,463,-171
24510270502,Census Tract 2705.02, Baltimore city,911,195,143,68,64,34,207,260,-53
24031703206,Census Tract 7032.06, Montgomery County,718,209,178,84,38,31,216,355,-139
24033807409,Census Tract 8074.09, Prince George's County,1238,183,266,105,55,49,321,286,35
24510240300,Census Tract 2403, Baltimore city,266,101,6,11,100,49,106,179,-73
24005401301,Census Tract 4013.01, Baltimore County,1046,208,181,104,95,76,276,374,-98
24510270701,Census Tract 2707.01, Baltimore city,559,172,239,114,65,47,304,434,-130
24510190200,Census Tract 1902, Baltimore city,343,161,53,46,30,37,83,133,-50
24033801804,Census Tract 8018.04, Prince George's County,349,107,40,29,12,20,52,68,-16
24031704806,Census Tract 7048.06, Montgomery County,541,145,129,62,206,83,335,203,132
24510200100,Census Tract 2001, Baltimore city,455,148,54,37,21,32,75,104,-29
24510110100,Census Tract 1101, Baltimore city,1022,219,270,148,713,194,983,1065,-82
24005441000,Census Tract 4410, Baltimore County,1348,289,182,87,106,68,288,192,96
24005491202,Census Tract 4912.02, Baltimore County,402,70,117,39,26,17,143,161,-18
24039930300,Census Tract 9303, Somerset County,502,108,173,54,8,14,181,72,109
24005421000,Census Tract 4210, Baltimore County,425,89,61,55,6,11,67,91,-24
24510271001,Census Tract 2710.01, Baltimore city,644,137,132,69,32,22,164,228,-64
24033800106,Census Tract 8001.06, Prince George's County,643,171,96,62,76,43,172,241,-69
24510260203,Census Tract 2602.03, Baltimore city,949,205,160,93,51,47,211,82,129
24005401302,Census Tract 4013.02, Baltimore County,611,148,166,82,25,41,191,111,80
24017850801,Census Tract 8508.01, Charles County,1025,227,165,84,40,32,205,337,-132
24510260401,Census Tract 2604.01, Baltimore city,1230,451,138,88,0,12,138,85,53
24013509002,Census Tract 5090.02, Carroll County,658,142,166,76,85,63,251,291,-40
24005400701,Census Tract 4007.01, Baltimore County,875,164,212,106,118,71,330,367,-37
24005411307,Census Tract 4113.07, Baltimore County,994,168,314,88,57,35,371,465,-94
24033800511,Census Tract 8005.11, Prince George's County,1131,242,224,112,138,66,362,511,-149
24510150200,Census Tract 1502, Baltimore city,609,215,106,85,10,16,116,147,-31
24025306500,Census Tract 3065, Harford County,1117,295,330,235,96,50,426,454,-28
24510060300,Census Tract 603, Baltimore city,389,90,34,24,80,48,114,227,-113
24031700904,Census Tract 7009.04, Montgomery County,817,216,190,107,101,71,291,158,133
24005403202,Census Tract 4032.02, Baltimore County,582,149,160,89,43,32,203,291,-88
24031701421,Census Tract 7014.21, Montgomery County,495,103,174,59,62,35,236,228,8
24031700822,Census Tract 7008.22, Montgomery County,506,115,151,78,27,24,178,81,97
24003702209,Census Tract 7022.09, Anne Arundel County,1420,144,218,85,101,66,319,462,-143
24031701202,Census Tract 7012.02, Montgomery County,672,84,58,29,47,40,105,192,-87
24033803803,Census Tract 8038.03, Prince George's County,1600,284,258,118,0,17,258,369,-111
24005430900,Census Tract 4309, Baltimore County,975,288,293,185,163,123,456,822,-366
24031704600,Census Tract 7046, Montgomery County,1227,177,81,59,25,29,106,333,-227
24005440701,Census Tract 4407.01, Baltimore County,1338,366,387,168,150,85,537,639,-102
24005420303,Census Tract 4203.03, Baltimore County,285,110,140,62,9,13,149,73,76
24005408703,Census Tract 4087.03, Baltimore County,1569,193,244,116,164,89,408,395,13
24001000100,Census Tract 1, Allegany County,703,143,162,77,0,12,162,80,82
24005401000,Census Tract 4010, Baltimore County,497,86,80,50,26,21,106,118,-12
24031701508,Census Tract 7015.08, Montgomery County,1100,268,269,130,103,59,372,464,-92
24025303900,Census Tract 3039, Harford County,626,90,130,54,35,24,165,157,8
24510260800,Census Tract 2608, Baltimore city,389,180,34,37,68,73,102,122,-20
24003701102,Census Tract 7011.02, Anne Arundel County,1426,267,312,164,178,113,490,310,180
24005400100,Census Tract 4001, Baltimore County,553,260,284,228,33,46,317,217,100
24005421102,Census Tract 4211.02, Baltimore County,634,154,94,63,16,17,110,99,11
24031701417,Census Tract 7014.17, Montgomery County,1693,407,401,203,287,135,688,829,-141
24043000301,Census Tract 3.01, Washington County,627,187,50,35,47,48,97,132,-35
24031700723,Census Tract 7007.23, Montgomery County,462,133,107,75,51,56,158,158,0
24005430101,Census Tract 4301.01, Baltimore County,1347,217,195,103,80,70,275,362,-87
24019970702,Census Tract 9707.02, Dorchester County,589,122,141,56,34,40,175,133,42
24003740203,Census Tract 7402.03, Anne Arundel County,1606,230,356,144,99,66,455,418,37
24510260302,Census Tract 2603.02, Baltimore city,1851,532,329,220,169,120,498,658,-160
24027606606,Census Tract 6066.06, Howard County,1450,312,548,186,71,55,619,398,221
24033803607,Census Tract 8036.07, Prince George's County,917,232,233,118,39,43,272,284,-12
24013507801,Census Tract 5078.01, Carroll County,1536,228,264,126,89,73,353,320,33
24031703701,Census Tract 7037.01, Montgomery County,1130,230,270,107,22,36,292,314,-22
24005402303,Census Tract 4023.03, Baltimore County,1353,323,388,169,184,132,572,611,-39
24510210200,Census Tract 2102, Baltimore city,683,248,73,60,79,51,152,344,-192
24021750506,Census Tract 7505.06, Frederick County,1310,269,286,145,77,43,363,301,62
24031701206,Census Tract 7012.06, Montgomery County,1975,259,286,125,76,57,362,295,67
24510090500,Census Tract 905, Baltimore city,384,132,60,39,14,17,74,103,-29
24510080301,Census Tract 803.01, Baltimore city,373,129,43,39,54,42,97,115,-18
24005450800,Census Tract 4508, Baltimore County,1021,230,131,97,12,19,143,107,36
24021765100,Census Tract 7651, Frederick County,881,159,142,95,107,87,249,275,-26
24017850710,Census Tract 8507.10, Charles County,1885,250,535,172,84,61,619,558,61
24033801805,Census Tract 8018.05, Prince George's County,268,133,41,40,23,29,64,117,-53
24023000400,Census Tract 4, Garrett County,539,113,94,72,15,20,109,254,-145
24005980200,Census Tract 9802, Baltimore County,0,12,0,12,0,12,0,0,0
24033801702,Census Tract 8017.02, Prince George's County,1027,204,217,104,19,22,236,306,-70
24510270301,Census Tract 2703.01, Baltimore city,721,204,86,59,68,53,154,301,-147
24033803516,Census Tract 8035.16, Prince George's County,1201,234,278,119,144,108,422,674,-252
24005402406,Census Tract 4024.06, Baltimore County,1585,345,420,197,106,90,526,897,-371
24005491401,Census Tract 4914.01, Baltimore County,1720,430,479,208,74,95,553,659,-106
24031703402,Census Tract 7034.02, Montgomery County,962,154,157,70,53,32,210,214,-4
24510272007,Census Tract 2720.07, Baltimore city,1434,471,96,57,64,62,160,332,-172
24510120300,Census Tract 1203, Baltimore city,812,257,150,84,197,82,347,362,-15
24003750900,Census Tract 7509, Anne Arundel County,714,134,173,71,64,54,237,143,94
24510010400,Census Tract 104, Baltimore city,276,110,57,58,116,90,173,247,-74
24031700819,Census Tract 7008.19, Montgomery County,1786,281,546,172,0,17,546,420,126
24005440200,Census Tract 4402, Baltimore County,489,126,90,60,46,36,136,146,-10
24031701220,Census Tract 7012.20, Montgomery County,1218,178,266,100,86,56,352,215,137
24031700719,Census Tract 7007.19, Montgomery County,2880,535,657,256,197,97,854,802,52
24510280101,Census Tract 2801.01, Baltimore city,852,247,116,103,55,46,171,269,-98
24005411306,Census Tract 4113.06, Baltimore County,1095,209,284,139,37,42,321,323,-2
24017851002,Census Tract 8510.02, Charles County,2532,357,424,150,168,105,592,625,-33
24003751102,Census Tract 7511.02, Anne Arundel County,712,182,274,109,38,30,312,405,-93
24510271801,Census Tract 2718.01, Baltimore city,404,179,158,87,13,20,171,141,30
24033807102,Census Tract 8071.02, Prince George's County,653,178,221,118,223,126,444,574,-130
24510090600,Census Tract 906, Baltimore city,774,346,104,85,7,15,111,106,5
24510040200,Census Tract 402, Baltimore city,723,187,444,152,257,146,701,631,70
24510090700,Census Tract 907, Baltimore city,800,411,59,69,116,115,175,198,-23
24029950300,Census Tract 9503, Kent County,1749,218,1273,158,33,42,1306,1348,-42
24025303605,Census Tract 3036.05, Harford County,1678,269,319,108,95,134,414,404,10
24005401200,Census Tract 4012, Baltimore County,727,142,138,68,34,37,172,256,-84
24033803601,Census Tract 8036.01, Prince George's County,876,202,228,95,9,15,237,223,14
24033803200,Census Tract 8032, Prince George's County,654,146,192,83,56,43,248,114,134
24005491201,Census Tract 4912.01, Baltimore County,314,71,108,45,22,19,130,271,-141
24027601107,Census Tract 6011.07, Howard County,1750,390,456,193,115,72,571,359,212
24025301302,Census Tract 3013.02, Harford County,1893,393,305,171,21,33,326,484,-158
24021750200,Census Tract 7502, Frederick County,382,120,147,85,62,60,209,214,-5
24001001800,Census Tract 18, Allegany County,2832,289,2280,285,108,51,2388,2708,-320
24005420100,Census Tract 4201, Baltimore County,782,176,114,57,48,33,162,192,-30
24005491100,Census Tract 4911, Baltimore County,1344,192,327,141,64,38,391,310,81
24005403402,Census Tract 4034.02, Baltimore County,1165,453,112,67,29,36,141,336,-195
24510120400,Census Tract 1204, Baltimore city,564,164,141,69,26,24,167,168,-1
24005401506,Census Tract 4015.06, Baltimore County,1350,206,205,95,106,67,311,522,-211
24005404403,Census Tract 4044.03, Baltimore County,1577,369,207,118,84,68,291,589,-298
24033801406,Census Tract 8014.06, Prince George's County,750,168,80,77,71,64,151,303,-152
24033807407,Census Tract 8074.07, Prince George's County,1382,374,323,183,231,133,554,780,-226
24031700611,Census Tract 7006.11, Montgomery County,1858,159,296,112,41,30,337,423,-86
24031702101,Census Tract 7021.01, Montgomery County,1821,267,452,149,21,23,473,564,-91
24029950500,Census Tract 9505, Kent County,483,147,53,38,0,12,53,70,-17
24047951700,Census Tract 9517, Worcester County,678,234,44,33,25,41,69,247,-178
24017850500,Census Tract 8505, Charles County,558,122,79,44,39,31,118,226,-108
24510060100,Census Tract 601, Baltimore city,462,169,90,76,50,38,140,175,-35
24510150702,Census Tract 1507.02, Baltimore city,355,165,7,10,57,56,64,91,-27
24017851100,Census Tract 8511, Charles County,826,204,231,129,49,31,280,103,177
24003740103,Census Tract 7401.03, Anne Arundel County,1741,431,402,163,102,84,504,685,-181
24031705501,Census Tract 7055.01, Montgomery County,265,94,10,21,106,74,116,156,-40
24031705701,Census Tract 7057.01, Montgomery County,1386,187,103,69,128,56,231,241,-10
24015030400,Census Tract 304, Cecil County,1240,330,189,146,60,57,249,145,104
24015030700,Census Tract 307, Cecil County,960,163,110,60,47,40,157,152,5
24027602700,Census Tract 6027, Howard County,1784,159,194,82,88,56,282,273,9
24003706500,Census Tract 7065, Anne Arundel County,970,258,110,85,101,73,211,396,-185
24033800606,Census Tract 8006.06, Prince George's County,1474,388,333,159,224,116,557,555,2
24033801411,Census Tract 8014.11, Prince George's County,741,211,50,42,18,21,68,259,-191
24031701317,Census Tract 7013.17, Montgomery County,1303,202,200,86,16,20,216,272,-56
24027606805,Census Tract 6068.05, Howard County,1071,124,173,75,123,57,296,338,-42
24005492500,Census Tract 4925, Baltimore County,2699,598,2679,595,0,12,2679,2867,-188
24041960600,Census Tract 9606, Talbot County,269,74,26,25,23,24,49,71,-22
24041960201,Census Tract 9602.01, Talbot County,771,146,194,82,49,33,243,106,137
24041960502,Census Tract 9605.02, Talbot County,913,183,123,70,85,58,208,235,-27
24005408506,Census Tract 4085.06, Baltimore County,1302,389,598,275,107,95,705,635,70
24013507802,Census Tract 5078.02, Carroll County,1151,211,282,112,20,21,302,363,-61
24031701506,Census Tract 7015.06, Montgomery County,1113,175,243,86,105,67,348,300,48
24027603004,Census Tract 6030.04, Howard County,1933,265,390,186,81,62,471,422,49
24027604002,Census Tract 6040.02, Howard County,2455,337,421,127,58,62,479,555,-76
24005491500,Census Tract 4915, Baltimore County,1193,275,498,183,96,66,594,532,62
24031701205,Census Tract 7012.05, Montgomery County,2123,194,189,100,169,85,358,433,-75
24031701407,Census Tract 7014.07, Montgomery County,1399,242,358,136,127,84,485,524,-39
24031702500,Census Tract 7025, Montgomery County,1050,276,219,109,498,173,717,848,-131
24043001001,Census Tract 10.01, Washington County,907,243,136,94,47,45,183,211,-28
24005411404,Census Tract 4114.04, Baltimore County,757,164,87,61,45,27,132,231,-99
24005450900,Census Tract 4509, Baltimore County,611,168,234,140,22,25,256,184,72
24033802804,Census Tract 8028.04, Prince George's County,1028,285,92,70,76,69,168,262,-94
24021751003,Census Tract 7510.03, Frederick County,1359,224,243,133,108,68,351,320,31
24001002100,Census Tract 21, Allegany County,617,112,67,34,23,30,90,216,-126
24003740900,Census Tract 7409, Anne Arundel County,2205,374,330,136,207,105,537,666,-129
24027605502,Census Tract 6055.02, Howard County,1346,359,344,186,206,130,550,418,132
24005452000,Census Tract 4520, Baltimore County,361,124,43,33,51,44,94,60,34
24027602800,Census Tract 6028, Howard County,1901,278,361,126,76,59,437,504,-67
24033800513,Census Tract 8005.13, Prince George's County,1748,371,225,117,170,104,395,557,-162
24033800103,Census Tract 8001.03, Prince George's County,550,190,75,59,71,54,146,165,-19
24021775600,Census Tract 7756, Frederick County,1097,134,109,53,73,48,182,229,-47
24021750802,Census Tract 7508.02, Frederick County,1631,314,587,256,168,80,755,189,566
24021751203,Census Tract 7512.03, Frederick County,383,51,64,26,23,16,87,99,-12
24005452300,Census Tract 4523, Baltimore County,539,149,40,42,0,12,40,17,23
24047950800,Census Tract 9508, Worcester County,1318,245,257,146,21,35,278,182,96
24031701703,Census Tract 7017.03, Montgomery County,929,186,197,72,140,96,337,417,-80
24041960300,Census Tract 9603, Talbot County,1035,254,229,103,32,35,261,223,38
24510250301,Census Tract 2503.01, Baltimore city,731,179,65,50,17,21,82,167,-85
24031701004,Census Tract 7010.04, Montgomery County,2080,324,487,130,79,57,566,390,176
24031702401,Census Tract 7024.01, Montgomery County,560,85,83,49,18,16,101,171,-70
24031702402,Census Tract 7024.02, Montgomery County,1202,284,156,88,365,148,521,457,64
24031702601,Census Tract 7026.01, Montgomery County,728,222,179,132,348,120,527,860,-333
24005420401,Census Tract 4204.01, Baltimore County,2093,368,146,143,71,116,217,417,-200
24033801404,Census Tract 8014.04, Prince George's County,791,202,56,41,82,53,138,245,-107
24003731203,Census Tract 7312.03, Anne Arundel County,2058,269,313,159,80,73,393,566,-173
24043000800,Census Tract 8, Washington County,626,143,35,38,28,25,63,202,-139
24005406000,Census Tract 4060, Baltimore County,1573,301,261,166,34,38,295,387,-92
24005407002,Census Tract 4070.02, Baltimore County,1485,196,281,112,89,50,370,411,-41
24037875300,Census Tract 8753, St. Mary's County,430,142,75,50,15,25,90,179,-89
24037875600,Census Tract 8756, St. Mary's County,2071,392,347,183,250,112,597,801,-204
24003731311,Census Tract 7313.11, Anne Arundel County,2036,322,545,195,210,113,755,652,103
24005403602,Census Tract 4036.02, Baltimore County,1832,250,254,113,134,85,388,313,75
24005420900,Census Tract 4209, Baltimore County,581,182,114,60,42,51,156,161,-5
24025303102,Census Tract 3031.02, Harford County,720,85,129,53,29,22,158,215,-57
24005450100,Census Tract 4501, Baltimore County,774,180,191,112,78,56,269,260,9
24005411102,Census Tract 4111.02, Baltimore County,690,139,211,80,40,31,251,248,3
24025303603,Census Tract 3036.03, Harford County,2268,283,426,171,86,50,512,572,-60
24019970300,Census Tract 9703, Dorchester County,929,227,44,38,64,47,108,289,-181
24005492001,Census Tract 4920.01, Baltimore County,288,69,78,39,13,15,91,133,-42
24033803300,Census Tract 8033, Prince George's County,1283,211,169,94,52,55,221,268,-47
24031700311,Census Tract 7003.11, Montgomery County,3318,354,440,162,228,91,668,576,92
24045010603,Census Tract 106.03, Wicomico County,1558,482,672,266,233,104,905,676,229
24045010501,Census Tract 105.01, Wicomico County,1864,366,571,274,36,29,607,632,-25
24045010701,Census Tract 107.01, Wicomico County,861,204,124,72,37,42,161,175,-14
24021751201,Census Tract 7512.01, Frederick County,1586,243,419,131,110,73,529,528,1
24043010801,Census Tract 108.01, Washington County,991,152,177,96,69,65,246,235,11
24047950300,Census Tract 9503, Worcester County,301,122,147,88,27,31,174,139,35
24033807404,Census Tract 8074.04, Prince George's County,1727,310,502,183,156,82,658,486,172
24033800514,Census Tract 8005.14, Prince George's County,1905,245,433,141,238,102,671,739,-68
24003740601,Census Tract 7406.01, Anne Arundel County,2003,256,352,106,179,103,531,552,-21
24033807200,Census Tract 8072, Prince George's County,13224,548,13090,546,125,59,13215,14243,-1028
24033800507,Census Tract 8005.07, Prince George's County,744,181,196,90,22,23,218,420,-202
24033801305,Census Tract 8013.05, Prince George's County,1587,255,301,146,128,80,429,276,153
24510080200,Census Tract 802, Baltimore city,246,107,55,48,0,12,55,56,-1
24033800409,Census Tract 8004.09, Prince George's County,1476,413,603,226,69,72,672,539,133
24025302802,Census Tract 3028.02, Harford County,868,229,257,84,88,59,345,553,-208
24033803608,Census Tract 8036.08, Prince George's County,2160,357,545,143,79,47,624,352,272
24033804600,Census Tract 8046, Prince George's County,803,125,114,49,47,29,161,167,-6
24033800108,Census Tract 8001.08, Prince George's County,1020,251,152,65,197,130,349,315,34
24021766800,Census Tract 7668, Frederick County,2683,225,1840,223,213,127,2053,1962,91
24037875700,Census Tract 8757, St. Mary's County,1644,292,234,115,16,28,250,422,-172
24037876200,Census Tract 8762, St. Mary's County,2732,333,1696,292,39,46,1735,1946,-211
24037875202,Census Tract 8752.02, St. Mary's County,1602,369,314,156,117,111,431,448,-17
24027603001,Census Tract 6030.01, Howard County,1710,191,138,77,141,93,279,304,-25
24033801706,Census Tract 8017.06, Prince George's County,420,101,60,32,0,12,60,71,-11
24033806710,Census Tract 8067.10, Prince George's County,1477,256,497,202,215,138,712,651,61
24033807405,Census Tract 8074.05, Prince George's County,1126,305,308,161,92,69,400,633,-233
24033801214,Census Tract 8012.14, Prince George's County,866,195,103,64,27,26,130,274,-144
24033801904,Census Tract 8019.04, Prince George's County,699,221,147,77,24,31,171,221,-50
24031703401,Census Tract 7034.01, Montgomery County,1156,171,244,112,17,25,261,297,-36
24031700810,Census Tract 7008.10, Montgomery County,1279,287,227,78,134,73,361,343,18
24003730401,Census Tract 7304.01, Anne Arundel County,1390,314,364,217,89,66,453,412,41
24033805700,Census Tract 8057, Prince George's County,1298,315,366,130,117,51,483,449,34
24033800509,Census Tract 8005.09, Prince George's County,2402,525,482,240,319,221,801,664,137
24025303700,Census Tract 3037, Harford County,869,183,106,56,86,55,192,208,-16
24031701215,Census Tract 7012.15, Montgomery County,1323,320,330,180,370,163,700,471,229
24031700720,Census Tract 7007.20, Montgomery County,1028,151,163,67,49,29,212,206,6
24003730604,Census Tract 7306.04, Anne Arundel County,2256,269,374,143,213,108,587,505,82
24005402509,Census Tract 4025.09, Baltimore County,2970,549,846,321,180,108,1026,1153,-127
24021752303,Census Tract 7523.03, Frederick County,890,130,145,67,33,33,178,153,25
24033806400,Census Tract 8064, Prince George's County,1169,180,322,157,305,101,627,532,95
24510210100,Census Tract 2101, Baltimore city,511,155,108,64,147,58,255,313,-58
24003740201,Census Tract 7402.01, Anne Arundel County,1886,402,531,235,117,89,648,571,77
24510150900,Census Tract 1509, Baltimore city,799,233,156,94,43,41,199,244,-45
24033802406,Census Tract 8024.06, Prince George's County,562,156,97,49,43,32,140,135,5
24033807408,Census Tract 8074.08, Prince George's County,1239,476,130,95,159,89,289,476,-187
24003731003,Census Tract 7310.03, Anne Arundel County,1100,200,212,111,73,38,285,329,-44
24031703216,Census Tract 7032.16, Montgomery County,547,168,223,92,48,60,271,276,-5
24033800701,Census Tract 8007.01, Prince George's County,2094,349,341,136,227,144,568,374,194
24013507703,Census Tract 5077.03, Carroll County,570,119,78,51,96,69,174,265,-91
24013513001,Census Tract 5130.01, Carroll County,1307,205,306,99,73,45,379,290,89
24510261000,Census Tract 2610, Baltimore city,701,312,9,14,75,57,84,132,-48
24031706013,Census Tract 7060.13, Montgomery County,888,115,100,53,49,28,149,160,-11
24003740500,Census Tract 7405, Anne Arundel County,3321,703,854,358,601,269,1455,1630,-175
24003708004,Census Tract 7080.04, Anne Arundel County,1731,272,249,132,43,52,292,290,2
24005410200,Census Tract 4102, Baltimore County,1291,124,220,69,44,28,264,307,-43
24005408200,Census Tract 4082, Baltimore County,454,68,89,57,54,39,143,104,39
24005402506,Census Tract 4025.06, Baltimore County,1383,261,352,119,63,44,415,391,24
24005402604,Census Tract 4026.04, Baltimore County,1361,350,251,175,152,110,403,286,117
24021751904,Census Tract 7519.04, Frederick County,1086,154,215,87,36,31,251,232,19
24005411409,Census Tract 4114.09, Baltimore County,1373,199,383,119,130,67,513,495,18
24510080102,Census Tract 801.02, Baltimore city,521,147,68,43,5,7,73,157,-84
24510130600,Census Tract 1306, Baltimore city,544,154,97,53,245,93,342,454,-112
24510200200,Census Tract 2002, Baltimore city,341,210,22,29,14,24,36,152,-116
24510100100,Census Tract 1001, Baltimore city,466,226,39,32,0,12,39,73,-34
24011955201,Census Tract 9552.01, Caroline County,858,155,80,44,29,22,109,163,-54
24510270805,Census Tract 2708.05, Baltimore city,1403,303,286,133,119,61,405,275,130
24017850102,Census Tract 8501.02, Charles County,522,165,66,32,19,16,85,95,-10
24027606601,Census Tract 6066.01, Howard County,965,229,193,85,40,30,233,202,31
24031701219,Census Tract 7012.19, Montgomery County,1170,306,175,66,122,69,297,467,-170
24027605602,Census Tract 6056.02, Howard County,2423,438,897,284,280,128,1177,750,427
24001001900,Census Tract 19, Allegany County,706,124,70,42,36,30,106,143,-37
24001001502,Census Tract 15.02, Allegany County,345,167,124,136,4,7,128,159,-31
24015030903,Census Tract 309.03, Cecil County,1222,227,263,118,0,17,263,166,97
24015030100,Census Tract 301, Cecil County,857,217,248,119,27,33,275,228,47
24005430700,Census Tract 4307, Baltimore County,1081,154,202,105,61,47,263,455,-192
24031706008,Census Tract 7060.08, Montgomery County,1794,203,367,121,31,30,398,181,217
24025301106,Census Tract 3011.06, Harford County,1239,213,274,108,88,53,362,450,-88
24005404502,Census Tract 4045.02, Baltimore County,1016,230,259,128,56,54,315,362,-47
24005490100,Census Tract 4901, Baltimore County,791,101,89,44,60,45,149,202,-53
24510271501,Census Tract 2715.01, Baltimore city,975,138,34,28,82,50,116,194,-78
24510271700,Census Tract 2717, Baltimore city,716,219,170,125,82,78,252,277,-25
24005404101,Census Tract 4041.01, Baltimore County,1473,334,224,123,212,116,436,444,-8
24005408304,Census Tract 4083.04, Baltimore County,739,136,18,32,0,12,18,166,-148
24031701704,Census Tract 7017.04, Montgomery County,905,116,160,51,28,23,188,233,-45
24013505207,Census Tract 5052.07, Carroll County,1132,118,209,74,98,80,307,234,73
24005408100,Census Tract 4081, Baltimore County,1471,247,214,133,90,66,304,272,32
24005411202,Census Tract 4112.02, Baltimore County,813,218,242,133,55,62,297,264,33
24033801906,Census Tract 8019.06, Prince George's County,421,106,89,42,13,12,102,75,27
24021751301,Census Tract 7513.01, Frederick County,835,134,97,52,23,27,120,200,-80
24021750300,Census Tract 7503, Frederick County,284,94,67,46,40,27,107,72,35
24039930600,Census Tract 9306, Somerset County,537,123,72,56,0,12,72,117,-45
24033800214,Census Tract 8002.14, Prince George's County,1106,299,400,163,38,37,438,166,272
24033800208,Census Tract 8002.08, Prince George's County,2914,476,712,282,417,185,1129,829,300
24033800209,Census Tract 8002.09, Prince George's County,1069,255,201,88,10,15,211,272,-61
24005403300,Census Tract 4033, Baltimore County,640,109,113,44,45,32,158,187,-29
24033800601,Census Tract 8006.01, Prince George's County,375,122,116,51,35,22,151,164,-13
24033801310,Census Tract 8013.10, Prince George's County,1316,254,361,177,57,64,418,329,89
24033801313,Census Tract 8013.13, Prince George's County,635,183,139,81,33,42,172,229,-57
24031703100,Census Tract 7031, Montgomery County,1242,137,300,93,89,55,389,425,-36
24031700902,Census Tract 7009.02, Montgomery County,1001,191,278,109,31,34,309,356,-47
24031701410,Census Tract 7014.10, Montgomery County,2846,568,647,258,244,142,891,727,164
24003701101,Census Tract 7011.01, Anne Arundel County,929,206,151,82,29,29,180,171,9
24510190300,Census Tract 1903, Baltimore city,498,186,12,12,9,10,21,85,-64
24510250207,Census Tract 2502.07, Baltimore city,644,197,95,61,57,39,152,246,-94
24033803519,Census Tract 8035.19, Prince George's County,1307,340,285,129,124,97,409,476,-67
24025305200,Census Tract 3052, Harford County,576,222,82,51,0,12,82,87,-5
24043011000,Census Tract 110, Washington County,742,145,166,60,0,17,166,248,-82
24033803401,Census Tract 8034.01, Prince George's County,258,116,23,25,0,12,23,109,-86
24025303101,Census Tract 3031.01, Harford County,1332,278,326,166,20,35,346,356,-10
24039930500,Census Tract 9305, Somerset County,855,163,150,103,51,33,201,172,29
24021750600,Census Tract 7506, Frederick County,845,221,569,178,34,28,603,670,-67
24033804802,Census Tract 8048.02, Prince George's County,748,183,125,84,36,30,161,100,61
24047951500,Census Tract 9515, Worcester County,1017,225,246,110,39,36,285,135,150
24025303203,Census Tract 3032.03, Harford County,931,176,165,63,16,23,181,240,-59
24027606906,Census Tract 6069.06, Howard County,2258,409,423,172,255,118,678,587,91
24031701306,Census Tract 7013.06, Montgomery County,623,102,53,47,38,39,91,209,-118
24021751901,Census Tract 7519.01, Frederick County,1185,146,135,67,61,38,196,194,2
24025301107,Census Tract 3011.07, Harford County,574,190,134,88,23,36,157,287,-130
24025301704,Census Tract 3017.04, Harford County,988,234,344,119,66,46,410,361,49
24001001100,Census Tract 11, Allegany County,213,59,34,26,42,30,76,89,-13
24031701214,Census Tract 7012.14, Montgomery County,791,122,64,36,271,80,335,437,-102
24031706009,Census Tract 7060.09, Montgomery County,1594,329,222,121,71,53,293,235,58
24031700204,Census Tract 7002.04, Montgomery County,437,107,113,41,0,12,113,178,-65
24003706700,Census Tract 7067, Anne Arundel County,3854,1009,3613,1030,34,34,3647,4144,-497
24031701414,Census Tract 7014.14, Montgomery County,2122,568,672,294,53,62,725,1006,-281
24045010606,Census Tract 106.06, Wicomico County,706,122,123,75,44,32,167,343,-176
24013504202,Census Tract 5042.02, Carroll County,1384,259,334,175,72,57,406,195,211
24005403802,Census Tract 4038.02, Baltimore County,835,218,109,63,31,28,140,163,-23
24009860702,Census Tract 8607.02, Calvert County,817,194,199,99,45,42,244,222,22
24025301601,Census Tract 3016.01, Harford County,1886,402,412,148,77,65,489,666,-177
24043011500,Census Tract 115, Washington County,1811,283,285,162,50,64,335,443,-108
24043011201,Census Tract 112.01, Washington County,2228,265,403,147,121,98,524,725,-201
24021775302,Census Tract 7753.02, Frederick County,1214,148,138,47,81,57,219,176,43
24510270302,Census Tract 2703.02, Baltimore city,406,98,126,80,27,22,153,115,38
24033806200,Census Tract 8062, Prince George's County,1050,251,208,83,149,82,357,295,62
24033803527,Census Tract 8035.27, Prince George's County,693,198,193,99,153,115,346,250,96
24033803512,Census Tract 8035.12, Prince George's County,1807,381,565,203,326,144,891,1110,-219
24005411308,Census Tract 4113.08, Baltimore County,970,253,232,105,62,49,294,284,10
24021775400,Census Tract 7754, Frederick County,757,189,120,58,46,37,166,220,-54
24005451701,Census Tract 4517.01, Baltimore County,753,170,88,60,59,46,147,140,7
24021750702,Census Tract 7507.02, Frederick County,737,227,114,60,21,25,135,534,-399
24033801708,Census Tract 8017.08, Prince George's County,889,221,226,168,0,12,226,224,2
24027601108,Census Tract 6011.08, Howard County,1045,177,221,88,123,51,344,476,-132
24013514201,Census Tract 5142.01, Carroll County,1139,156,222,82,81,60,303,357,-54
24031701408,Census Tract 7014.08, Montgomery County,1749,261,428,166,126,77,554,448,106
24510090300,Census Tract 903, Baltimore city,962,235,230,104,55,43,285,220,65
24033803514,Census Tract 8035.14, Prince George's County,1269,322,181,189,300,146,481,283,198
24005491701,Census Tract 4917.01, Baltimore County,980,150,266,107,162,80,428,517,-89
24031700905,Census Tract 7009.05, Montgomery County,1011,189,142,77,76,44,218,222,-4
24017851302,Census Tract 8513.02, Charles County,1073,237,232,95,27,26,259,151,108
24510260501,Census Tract 2605.01, Baltimore city,998,449,71,51,55,60,126,196,-70
24033804002,Census Tract 8040.02, Prince George's County,1141,300,172,99,72,60,244,190,54
24017850400,Census Tract 8504, Charles County,713,155,58,34,10,18,68,228,-160
24033807304,Census Tract 8073.04, Prince George's County,472,124,103,46,17,14,120,121,-1
24005492402,Census Tract 4924.02, Baltimore County,1240,382,319,151,148,118,467,771,-304
24033802803,Census Tract 8028.03, Prince George's County,1322,312,127,86,101,86,228,309,-81
24037876001,Census Tract 8760.01, St. Mary's County,1220,415,262,112,47,46,309,437,-128
24510200701,Census Tract 2007.01, Baltimore city,942,243,184,115,11,18,195,230,-35
24025303201,Census Tract 3032.01, Harford County,1302,216,209,91,55,36,264,384,-120
24025301602,Census Tract 3016.02, Harford County,2485,362,869,231,121,116,990,772,218
24025303400,Census Tract 3034, Harford County,1270,126,230,76,58,39,288,342,-54
24025301201,Census Tract 3012.01, Harford County,405,61,71,30,11,15,82,130,-48
24025306300,Census Tract 3063, Harford County,757,151,144,66,111,57,255,141,114
24005411302,Census Tract 4113.02, Baltimore County,1013,168,123,66,37,27,160,181,-21
24031700833,Census Tract 7008.33, Montgomery County,982,274,162,78,29,33,191,337,-146
24031701307,Census Tract 7013.07, Montgomery County,1319,268,283,81,79,48,362,504,-142
24035810400,Census Tract 8104, Queen Anne's County,1420,291,262,122,32,36,294,265,29
24510110200,Census Tract 1102, Baltimore city,1508,295,559,170,797,222,1356,1249,107
24005440400,Census Tract 4404, Baltimore County,993,232,147,96,69,75,216,434,-218
24005490500,Census Tract 4905, Baltimore County,995,127,109,58,110,66,219,245,-26
24031703210,Census Tract 7032.10, Montgomery County,712,91,83,48,33,26,116,353,-237
24037875801,Census Tract 8758.01, St. Mary's County,505,115,174,75,14,14,188,197,-9
24510160801,Census Tract 1608.01, Baltimore city,659,292,132,122,34,55,166,106,60
24031701314,Census Tract 7013.14, Montgomery County,870,161,210,95,83,52,293,295,-2
24031701312,Census Tract 7013.12, Montgomery County,2116,256,509,185,195,141,704,541,163
24035810700,Census Tract 8107, Queen Anne's County,913,205,130,78,40,33,170,180,-10
24035810902,Census Tract 8109.02, Queen Anne's County,701,120,156,71,59,44,215,223,-8
24510270903,Census Tract 2709.03, Baltimore city,2860,800,2373,673,105,77,2478,1923,555
24033802002,Census Tract 8020.02, Prince George's County,854,235,361,138,22,28,383,289,94
24033805000,Census Tract 8050, Prince George's County,1745,455,358,282,246,168,604,510,94
24033801215,Census Tract 8012.15, Prince George's County,697,116,187,59,38,24,225,198,27
24031703208,Census Tract 7032.08, Montgomery County,1747,281,188,83,89,49,277,153,124
24005408702,Census Tract 4087.02, Baltimore County,516,104,80,44,0,12,80,178,-98
24005440900,Census Tract 4409, Baltimore County,833,221,164,78,60,39,224,333,-109
24510270600,Census Tract 2706, Baltimore city,901,278,195,144,134,68,329,375,-46
24005450504,Census Tract 4505.04, Baltimore County,1306,442,122,96,0,17,122,377,-255
24033801500,Census Tract 8015, Prince George's County,662,157,98,51,39,21,137,134,3
24039980400,Census Tract 9804, Somerset County,423,180,37,26,0,12,37,49,-12
24025305300,Census Tract 3053, Harford County,349,63,70,37,13,14,83,129,-46
24021740200,Census Tract 7402, Frederick County,1111,153,175,79,72,52,247,388,-141
24021751701,Census Tract 7517.01, Frederick County,508,86,108,60,38,38,146,151,-5
24023000300,Census Tract 3, Garrett County,646,118,124,62,12,19,136,63,73
24043010802,Census Tract 108.02, Washington County,548,131,52,41,20,17,72,165,-93
24005408400,Census Tract 4084, Baltimore County,133,50,11,11,48,27,59,6,53
24035810300,Census Tract 8103, Queen Anne's County,967,204,204,113,57,40,261,303,-42
24017850902,Census Tract 8509.02, Charles County,1186,276,322,146,47,34,369,226,143
24039930101,Census Tract 9301.01, Somerset County,3920,409,2573,338,187,119,2760,3095,-335
24031703602,Census Tract 7036.02, Montgomery County,635,176,83,53,39,39,122,153,-31
24031703404,Census Tract 7034.04, Montgomery County,718,156,203,85,24,18,227,203,24
24005451100,Census Tract 4511, Baltimore County,710,102,83,46,53,42,136,143,-7
24009860102,Census Tract 8601.02, Calvert County,623,115,68,42,33,28,101,109,-8
24009860101,Census Tract 8601.01, Calvert County,670,131,127,68,21,24,148,159,-11
24009860501,Census Tract 8605.01, Calvert County,2316,347,312,112,222,182,534,387,147
24009860801,Census Tract 8608.01, Calvert County,1728,275,448,167,76,61,524,495,29
24037875901,Census Tract 8759.01, St. Mary's County,1793,385,537,239,159,102,696,605,91
24031701423,Census Tract 7014.23, Montgomery County,1473,247,265,105,78,39,343,483,-140
24033801905,Census Tract 8019.05, Prince George's County,1263,276,325,137,85,41,410,556,-146
24003740304,Census Tract 7403.04, Anne Arundel County,1496,341,550,214,124,86,674,460,214
24013505102,Census Tract 5051.02, Carroll County,1439,190,343,97,67,55,410,387,23
24013508102,Census Tract 5081.02, Carroll County,681,175,128,81,54,37,182,158,24
24013506102,Census Tract 5061.02, Carroll County,893,183,237,87,70,52,307,282,25
24017850712,Census Tract 8507.12, Charles County,1434,336,384,155,95,54,479,398,81
24013501002,Census Tract 5010.02, Carroll County,760,291,188,108,38,60,226,369,-143
24003702602,Census Tract 7026.02, Anne Arundel County,1368,219,203,167,28,33,231,226,5
24031701509,Census Tract 7015.09, Montgomery County,2177,420,558,195,37,43,595,809,-214
24031701505,Census Tract 7015.05, Montgomery County,2184,496,544,194,182,104,726,661,65
24031705601,Census Tract 7056.01, Montgomery County,733,133,69,60,15,17,84,85,-1
24031705903,Census Tract 7059.03, Montgomery County,1388,210,99,76,87,59,186,243,-57
24003731307,Census Tract 7313.07, Anne Arundel County,1704,373,402,194,189,131,591,678,-87
24005408507,Census Tract 4085.07, Baltimore County,1702,400,584,283,230,98,814,604,210
24005440500,Census Tract 4405, Baltimore County,648,98,42,29,32,30,74,162,-88
24033801213,Census Tract 8012.13, Prince George's County,758,226,74,42,50,54,124,129,-5
24510080101,Census Tract 801.01, Baltimore city,1007,249,99,70,53,40,152,126,26
24031704804,Census Tract 7048.04, Montgomery County,255,64,8,13,61,36,69,241,-172
24013511000,Census Tract 5110, Carroll County,828,147,173,65,8,13,181,252,-71
24013506101,Census Tract 5061.01, Carroll County,1213,194,363,135,26,26,389,424,-35
24013509001,Census Tract 5090.01, Carroll County,1100,200,162,81,26,24,188,261,-73
24025303606,Census Tract 3036.06, Harford County,1060,135,171,70,96,50,267,147,120
24005491402,Census Tract 4914.02, Baltimore County,750,233,263,124,50,44,313,269,44
24510010300,Census Tract 103, Baltimore city,318,98,57,40,156,56,213,340,-127
24031700400,Census Tract 7004, Montgomery County,462,102,125,53,7,9,132,141,-9
24031700826,Census Tract 7008.26, Montgomery County,1339,186,106,76,107,78,213,143,70
24031700616,Census Tract 7006.16, Montgomery County,1422,234,356,170,84,42,440,328,112
24005400600,Census Tract 4006, Baltimore County,699,190,191,129,27,25,218,280,-62
24510280404,Census Tract 2804.04, Baltimore city,549,186,98,69,31,25,129,167,-38
24017850711,Census Tract 8507.11, Charles County,1595,326,304,126,115,82,419,429,-10
24017851001,Census Tract 8510.01, Charles County,882,166,203,112,8,14,211,145,66
24033800211,Census Tract 8002.11, Prince George's County,949,375,206,166,126,106,332,231,101
24021770700,Census Tract 7707, Frederick County,696,112,129,54,18,21,147,195,-48
24033807410,Census Tract 8074.10, Prince George's County,1329,263,329,146,71,50,400,260,140
24033801217,Census Tract 8012.17, Prince George's County,896,158,249,108,73,49,322,326,-4
24031700105,Census Tract 7001.05, Montgomery County,1852,378,575,246,82,74,657,662,-5
24003740104,Census Tract 7401.04, Anne Arundel County,2787,481,843,267,217,110,1060,873,187
24031700606,Census Tract 7006.06, Montgomery County,1204,169,153,79,83,55,236,240,-4
24031700613,Census Tract 7006.13, Montgomery County,1779,229,366,116,192,91,558,458,100
24031703221,Census Tract 7032.21, Montgomery County,1580,223,245,89,193,91,438,410,28
24027602306,Census Tract 6023.06, Howard County,1556,274,196,104,152,96,348,399,-51
24027603003,Census Tract 6030.03, Howard County,1098,156,203,85,68,40,271,255,16
24017850713,Census Tract 8507.13, Charles County,2279,464,341,153,195,164,536,516,20
24033801600,Census Tract 8016, Prince George's County,527,236,277,173,12,19,289,48,241
24033803605,Census Tract 8036.05, Prince George's County,1694,306,270,108,119,57,389,726,-337
24027606806,Census Tract 6068.06, Howard County,2619,305,389,171,159,101,548,600,-52
24005490701,Census Tract 4907.01, Baltimore County,293,71,55,43,30,30,85,62,23
24005490800,Census Tract 4908, Baltimore County,1237,229,587,235,11,16,598,924,-326
24005491600,Census Tract 4916, Baltimore County,889,220,79,51,43,41,122,377,-255
24033807305,Census Tract 8073.05, Prince George's County,745,226,229,96,21,24,250,495,-245
24027602305,Census Tract 6023.05, Howard County,1101,140,168,82,78,46,246,215,31
24027602100,Census Tract 6021, Howard County,2243,258,419,119,216,105,635,645,-10
24031700604,Census Tract 7006.04, Montgomery County,1668,208,342,132,38,45,380,330,50
24031700811,Census Tract 7008.11, Montgomery County,1285,256,326,145,61,42,387,383,4
24025302400,Census Tract 3024, Harford County,1017,213,224,93,64,53,288,215,73
24005411101,Census Tract 4111.01, Baltimore County,431,78,84,49,51,51,135,95,40
24003750801,Census Tract 7508.01, Anne Arundel County,1381,291,345,160,125,102,470,327,143
24033806800,Census Tract 8068, Prince George's County,951,183,303,115,59,49,362,438,-76
24033807000,Census Tract 8070, Prince George's County,3177,457,1783,471,782,263,2565,2329,236
24017851200,Census Tract 8512, Charles County,1137,247,148,70,44,36,192,255,-63
24021750505,Census Tract 7505.05, Frederick County,2569,521,430,203,71,58,501,287,214
24021750701,Census Tract 7507.01, Frederick County,1398,197,268,89,91,59,359,426,-67
24005421200,Census Tract 4212, Baltimore County,324,77,67,43,0,12,67,59,8
24005452100,Census Tract 4521, Baltimore County,605,197,140,71,40,53,180,314,-134
24011955600,Census Tract 9556, Caroline County,1169,138,144,55,27,33,171,167,4
24031700104,Census Tract 7001.04, Montgomery County,1457,224,298,101,90,44,388,451,-63
24031705000,Census Tract 7050, Montgomery County,1327,187,249,136,127,53,376,362,14
24005492300,Census Tract 4923, Baltimore County,824,253,92,43,24,23,116,220,-104
24005490301,Census Tract 4903.01, Baltimore County,2276,399,1394,362,298,166,1692,1210,482
24027602302,Census Tract 6023.02, Howard County,2378,332,606,208,244,128,850,633,217
24033801410,Census Tract 8014.10, Prince George's County,613,181,79,57,10,15,89,237,-148
24003740800,Census Tract 7408, Anne Arundel County,1042,175,195,65,26,27,221,288,-67
24510280102,Census Tract 2801.02, Baltimore city,1490,450,384,254,156,178,540,252,288
24031700721,Census Tract 7007.21, Montgomery County,664,192,127,86,127,70,254,295,-41
24510120202,Census Tract 1202.02, Baltimore city,3584,438,3116,375,381,144,3497,4743,-1246
24015030505,Census Tract 305.05, Cecil County,1445,263,351,129,58,46,409,229,180
24001002000,Census Tract 20, Allegany County,1010,248,134,95,31,47,165,439,-274
24033800105,Census Tract 8001.05, Prince George's County,1107,220,226,164,99,58,325,393,-68
24005411406,Census Tract 4114.06, Baltimore County,937,118,162,73,72,44,234,375,-141
24005451000,Census Tract 4510, Baltimore County,182,52,25,21,5,7,30,60,-30
24001000300,Census Tract 3, Allegany County,641,156,130,87,0,12,130,93,37
24001001200,Census Tract 12, Allegany County,778,202,180,93,43,31,223,194,29
24001001300,Census Tract 13, Allegany County,604,116,74,40,39,30,113,186,-73
24510230300,Census Tract 2303, Baltimore city,152,53,15,13,118,48,133,178,-45
24510070200,Census Tract 702, Baltimore city,993,442,13,19,19,29,32,90,-58
24510271200,Census Tract 2712, Baltimore city,1505,301,128,153,119,90,247,450,-203
24510160700,Census Tract 1607, Baltimore city,1280,344,277,126,78,73,355,267,88
24510271900,Census Tract 2719, Baltimore city,654,218,57,43,62,47,119,267,-148
24510030200,Census Tract 302, Baltimore city,390,109,26,22,112,57,138,194,-56
24005492200,Census Tract 4922, Baltimore County,1047,270,285,151,19,23,304,455,-151
24033802001,Census Tract 8020.01, Prince George's County,1028,292,138,113,41,67,179,283,-104
24041960501,Census Tract 9605.01, Talbot County,1314,170,222,87,31,27,253,231,22
24025306400,Census Tract 3064, Harford County,1765,313,426,144,114,65,540,523,17
24005403803,Census Tract 4038.03, Baltimore County,590,112,77,45,31,33,108,144,-36
24015031202,Census Tract 312.02, Cecil County,1031,269,184,119,44,44,228,270,-42
24033801407,Census Tract 8014.07, Prince George's County,1510,395,515,215,77,99,592,622,-30
24033800408,Census Tract 8004.08, Prince George's County,1744,384,389,218,28,29,417,684,-267
24003706600,Census Tract 7066, Anne Arundel County,1303,241,120,63,93,61,213,332,-119
24003731201,Census Tract 7312.01, Anne Arundel County,1864,237,176,96,100,84,276,430,-154
24005421300,Census Tract 4213, Baltimore County,559,168,114,69,37,42,151,170,-19
24015030602,Census Tract 306.02, Cecil County,1689,278,414,178,196,96,610,347,263
24033806706,Census Tract 8067.06, Prince George's County,793,243,106,65,131,76,237,510,-273
24025301108,Census Tract 3011.08, Harford County,712,141,134,58,10,16,144,246,-102
24045010502,Census Tract 105.02, Wicomico County,5086,718,3568,646,240,178,3808,3573,235
24045010200,Census Tract 102, Wicomico County,1678,390,94,79,0,17,94,319,-225
24033800410,Census Tract 8004.10, Prince George's County,2977,307,1670,281,172,77,1842,1822,20
24005408900,Census Tract 4089, Baltimore County,525,108,107,58,26,24,133,139,-6
24031702302,Census Tract 7023.02, Montgomery County,1057,166,165,96,35,23,200,271,-71
24031700903,Census Tract 7009.03, Montgomery County,773,121,197,70,22,18,219,151,68
24031700207,Census Tract 7002.07, Montgomery County,1706,177,295,114,83,45,378,461,-83
24043010400,Census Tract 104, Washington County,1888,349,362,144,51,73,413,554,-141
24043011302,Census Tract 113.02, Washington County,988,172,193,74,73,58,266,191,75
24043011301,Census Tract 113.01, Washington County,1452,160,224,97,78,39,302,401,-99
24045010604,Census Tract 106.04, Wicomico County,1265,250,218,78,24,23,242,349,-107
24045000100,Census Tract 1, Wicomico County,1668,342,136,79,63,51,199,361,-162
24005450503,Census Tract 4505.03, Baltimore County,1538,299,318,108,77,91,395,423,-28
24005403701,Census Tract 4037.01, Baltimore County,1225,187,176,101,105,71,281,400,-119
24045010300,Census Tract 103, Wicomico County,2612,493,167,109,197,99,364,457,-93
24031701701,Census Tract 7017.01, Montgomery County,1052,163,184,77,85,46,269,307,-38
24005421101,Census Tract 4211.01, Baltimore County,506,188,63,45,0,12,63,47,16
24510250103,Census Tract 2501.03, Baltimore city,530,130,91,59,15,16,106,162,-56
24031701213,Census Tract 7012.13, Montgomery County,1499,305,387,132,293,129,680,428,252
24033801006,Census Tract 8010.06, Prince George's County,921,164,258,100,98,64,356,564,-208
24005492002,Census Tract 4920.02, Baltimore County,853,166,264,115,41,38,305,371,-66
24005492101,Census Tract 4921.01, Baltimore County,841,139,113,72,22,26,135,276,-141
24033805909,Census Tract 8059.09, Prince George's County,1650,343,354,151,662,193,1016,1096,-80
24019970200,Census Tract 9702, Dorchester County,1150,193,109,56,94,62,203,238,-35
24045000500,Census Tract 5, Wicomico County,1238,370,414,275,0,12,414,284,130
24003740102,Census Tract 7401.02, Anne Arundel County,2261,454,633,233,275,123,908,804,104
24003750804,Census Tract 7508.04, Anne Arundel County,608,189,123,83,64,43,187,306,-119
24033803522,Census Tract 8035.22, Prince George's County,891,188,192,92,109,63,301,453,-152
24003702701,Census Tract 7027.01, Anne Arundel County,732,181,168,113,191,135,359,412,-53
24019970100,Census Tract 9701, Dorchester County,608,159,60,28,18,20,78,201,-123
24510150500,Census Tract 1505, Baltimore city,303,124,77,62,0,12,77,46,31
24043000900,Census Tract 9, Washington County,1051,234,130,88,20,28,150,250,-100
24047950900,Census Tract 9509, Worcester County,309,80,40,33,13,14,53,112,-59
24033801207,Census Tract 8012.07, Prince George's County,932,125,217,84,17,20,234,319,-85
24033801701,Census Tract 8017.01, Prince George's County,1132,319,159,96,45,34,204,411,-207
24033805602,Census Tract 8056.02, Prince George's County,1216,312,34,36,0,17,34,39,-5
24033800607,Census Tract 8006.07, Prince George's County,1627,259,397,129,203,106,600,657,-57
24037876100,Census Tract 8761, St. Mary's County,1458,340,296,163,56,47,352,223,129
24037875802,Census Tract 8758.02, St. Mary's County,1198,189,221,93,83,63,304,340,-36
24031705702,Census Tract 7057.02, Montgomery County,1282,189,219,91,78,46,297,223,74
24510220100,Census Tract 2201, Baltimore city,837,205,101,71,405,180,506,670,-164
24033801908,Census Tract 8019.08, Prince George's County,808,274,63,51,27,39,90,177,-87
24033800213,Census Tract 8002.13, Prince George's County,1309,262,300,111,194,74,494,386,108
24047950100,Census Tract 9501, Worcester County,281,124,57,55,11,13,68,59,9
24047951100,Census Tract 9511, Worcester County,1021,186,280,132,52,50,332,261,71
24510240100,Census Tract 2401, Baltimore city,486,118,64,52,165,68,229,232,-3
24033806712,Census Tract 8067.12, Prince George's County,966,234,339,196,66,72,405,409,-4
24510120600,Census Tract 1206, Baltimore city,348,121,62,50,190,88,252,357,-105
24031703403,Census Tract 7034.03, Montgomery County,950,138,237,73,45,24,282,374,-92
24031706007,Census Tract 7060.07, Montgomery County,1951,257,188,100,172,107,360,520,-160
24003750803,Census Tract 7508.03, Anne Arundel County,2086,441,362,193,39,40,401,703,-302
24031702900,Census Tract 7029, Montgomery County,948,236,70,69,187,120,257,399,-142
24031703213,Census Tract 7032.13, Montgomery County,1737,350,370,168,38,38,408,524,-116
24033801907,Census Tract 8019.07, Prince George's County,396,115,75,57,12,19,87,275,-188
24005404800,Census Tract 4048, Baltimore County,435,82,86,37,36,34,122,217,-95
24031700205,Census Tract 7002.05, Montgomery County,4004,396,747,212,226,136,973,677,296
24033800413,Census Tract 8004.13, Prince George's County,1286,280,389,153,74,67,463,483,-20
24033801302,Census Tract 8013.02, Prince George's County,590,122,114,64,53,33,167,250,-83
24033805907,Census Tract 8059.07, Prince George's County,852,212,243,112,21,17,264,346,-82
24021750803,Census Tract 7508.03, Frederick County,1681,308,329,120,184,133,513,561,-48
24021752201,Census Tract 7522.01, Frederick County,457,89,101,47,23,18,124,129,-5
24003731303,Census Tract 7313.03, Anne Arundel County,1405,244,308,141,30,34,338,395,-57
24021767500,Census Tract 7675, Frederick County,667,148,202,114,28,25,230,163,67
24025301702,Census Tract 3017.02, Harford County,2411,469,514,226,240,161,754,676,78
24027606707,Census Tract 6067.07, Howard County,1042,285,271,114,34,30,305,389,-84
24027606905,Census Tract 6069.05, Howard County,1956,376,473,299,230,128,703,310,393
24033800517,Census Tract 8005.17, Prince George's County,1584,304,310,148,435,261,745,537,208
24033800504,Census Tract 8005.04, Prince George's County,1359,308,258,102,126,70,384,481,-97
24033801104,Census Tract 8011.04, Prince George's County,927,215,263,105,62,35,325,441,-116
24025304202,Census Tract 3042.02, Harford County,1446,232,295,121,18,28,313,422,-109
24031700306,Census Tract 7003.06, Montgomery County,2533,335,361,168,107,78,468,537,-69
24031701006,Census Tract 7010.06, Montgomery County,1287,151,127,58,77,47,204,354,-150
24003740602,Census Tract 7406.02, Anne Arundel County,1332,222,414,126,62,32,476,356,120
24031700208,Census Tract 7002.08, Montgomery County,544,99,175,59,38,24,213,230,-17
24027601201,Census Tract 6012.01, Howard County,2071,365,325,134,102,78,427,721,-294
24027602304,Census Tract 6023.04, Howard County,1512,178,195,90,84,42,279,257,22
24027601204,Census Tract 6012.04, Howard County,1819,320,333,162,208,97,541,454,87
24033801309,Census Tract 8013.09, Prince George's County,693,187,170,81,64,46,234,202,32
24033801707,Census Tract 8017.07, Prince George's County,1457,366,103,76,83,59,186,330,-144
24027605102,Census Tract 6051.02, Howard County,3128,358,438,139,108,64,546,805,-259
24033800401,Census Tract 8004.01, Prince George's County,566,66,86,36,31,24,117,143,-26
24003731002,Census Tract 7310.02, Anne Arundel County,831,143,84,50,55,38,139,233,-94
24510160300,Census Tract 1603, Baltimore city,187,119,3,6,4,7,7,14,-7
24003731102,Census Tract 7311.02, Anne Arundel County,2047,392,214,110,117,105,331,491,-160
24031702301,Census Tract 7023.01, Montgomery County,939,203,198,105,144,102,342,228,114
24033800704,Census Tract 8007.04, Prince George's County,1536,267,272,125,181,166,453,550,-97
24510250600,Census Tract 2506, Baltimore city,0,12,0,12,0,12,0,0,0
24033806601,Census Tract 8066.01, Prince George's County,1274,233,166,88,0,12,166,192,-26
24005402602,Census Tract 4026.02, Baltimore County,610,174,168,67,44,31,212,208,4
24021752502,Census Tract 7525.02, Frederick County,593,67,108,48,16,17,124,145,-21
24003731204,Census Tract 7312.04, Anne Arundel County,1526,295,333,159,137,130,470,353,117
24005451500,Census Tract 4515, Baltimore County,1267,237,177,92,49,58,226,264,-38
24033800608,Census Tract 8006.08, Prince George's County,1793,236,344,123,216,109,560,470,90
24003707002,Census Tract 7070.02, Anne Arundel County,916,142,160,63,73,46,233,266,-33
24021752301,Census Tract 7523.01, Frederick County,1946,325,378,141,312,157,690,380,310
24005404202,Census Tract 4042.02, Baltimore County,3563,539,1724,356,235,130,1959,2018,-59
24025301301,Census Tract 3013.01, Harford County,688,169,213,81,46,45,259,277,-18
24013501001,Census Tract 5010.01, Carroll County,1383,218,183,91,41,46,224,311,-87
24043011202,Census Tract 112.02, Washington County,1341,251,218,91,81,47,299,280,19
24510080800,Census Tract 808, Baltimore city,724,173,14,23,19,22,33,43,-10
24031704000,Census Tract 7040, Montgomery County,1673,426,246,161,133,84,379,580,-201
24031701212,Census Tract 7012.12, Montgomery County,641,102,139,49,37,25,176,168,8
24011955302,Census Tract 9553.02, Caroline County,615,144,73,61,25,30,98,72,26
24031700710,Census Tract 7007.10, Montgomery County,1814,339,477,186,56,50,533,575,-42
24003730203,Census Tract 7302.03, Anne Arundel County,1264,341,285,151,131,103,416,364,52
24003751400,Census Tract 7514, Anne Arundel County,915,187,306,133,53,50,359,265,94
24031704200,Census Tract 7042, Montgomery County,639,104,136,61,35,22,171,87,84
24031700103,Census Tract 7001.03, Montgomery County,1228,148,285,85,87,58,372,644,-272
24031701315,Census Tract 7013.15, Montgomery County,1127,199,213,105,109,58,322,607,-285
24031704401,Census Tract 7044.01, Montgomery County,635,97,69,46,33,27,102,155,-53
24031705300,Census Tract 7053, Montgomery County,521,50,41,20,17,13,58,117,-59
24033805801,Census Tract 8058.01, Prince George's County,1119,324,261,147,99,81,360,213,147
24033806000,Census Tract 8060, Prince George's County,1402,265,203,109,50,41,253,520,-267
24033803100,Census Tract 8031, Prince George's County,580,174,122,63,36,31,158,202,-44
24033800515,Census Tract 8005.15, Prince George's County,1188,245,234,127,224,103,458,388,70
24510270804,Census Tract 2708.04, Baltimore city,511,242,233,183,44,36,277,238,39
24031702000,Census Tract 7020, Montgomery County,1616,274,261,117,55,42,316,432,-116
24021752001,Census Tract 7520.01, Frederick County,1394,217,258,104,117,63,375,388,-13
24025306100,Census Tract 3061, Harford County,878,166,119,78,99,59,218,191,27
24025306200,Census Tract 3062, Harford County,303,97,57,48,0,12,57,68,-11
24003702206,Census Tract 7022.06, Anne Arundel County,2264,324,501,206,230,110,731,558,173
24031700817,Census Tract 7008.17, Montgomery County,1604,322,427,156,306,129,733,448,285
24031701002,Census Tract 7010.02, Montgomery County,870,163,59,47,79,54,138,126,12
24031701900,Census Tract 7019, Montgomery County,845,176,206,151,63,45,269,352,-83
24510250203,Census Tract 2502.03, Baltimore city,554,101,78,44,26,23,104,187,-83
24510260201,Census Tract 2602.01, Baltimore city,1448,357,381,242,55,87,436,505,-69
24033800518,Census Tract 8005.18, Prince George's County,1042,166,145,59,47,48,192,264,-72
24510271400,Census Tract 2714, Baltimore city,1383,281,381,191,333,176,714,537,177
24003706401,Census Tract 7064.01, Anne Arundel County,1705,414,143,85,111,83,254,281,-27
24005492102,Census Tract 4921.02, Baltimore County,421,126,70,34,51,32,121,165,-44
24001000800,Census Tract 8, Allegany County,460,102,78,51,4,7,82,76,6
24001001401,Census Tract 14.01, Allegany County,668,168,180,90,71,61,251,273,-22
24005407001,Census Tract 4070.01, Baltimore County,552,126,99,56,6,10,105,152,-47
24005404402,Census Tract 4044.02, Baltimore County,1866,323,281,148,232,116,513,543,-30
24017851400,Census Tract 8514, Charles County,2074,329,405,164,122,90,527,553,-26
24017850300,Census Tract 8503, Charles County,415,137,91,57,0,12,91,111,-20
24017850904,Census Tract 8509.04, Charles County,3154,437,580,156,391,249,971,514,457
24005440100,Census Tract 4401, Baltimore County,1004,137,193,71,87,46,280,337,-57
24510260402,Census Tract 2604.02, Baltimore city,1021,326,143,83,70,59,213,219,-6
24003751700,Census Tract 7517, Anne Arundel County,702,108,113,62,28,28,141,153,-12
24005451300,Census Tract 4513, Baltimore County,1012,201,131,85,29,29,160,170,-10
24005420600,Census Tract 4206, Baltimore County,941,263,179,109,57,53,236,252,-16
24510260605,Census Tract 2606.05, Baltimore city,1110,273,95,80,60,61,155,263,-108
24003751600,Census Tract 7516, Anne Arundel County,536,111,97,70,63,49,160,142,18
24003701400,Census Tract 7014, Anne Arundel County,907,152,117,76,54,35,171,104,67
24031701211,Census Tract 7012.11, Montgomery County,1893,461,597,301,48,43,645,686,-41
24031700500,Census Tract 7005, Montgomery County,1919,291,449,173,108,77,557,406,151
24003707001,Census Tract 7070.01, Anne Arundel County,1343,220,272,132,159,91,431,402,29
24003741000,Census Tract 7410, Anne Arundel County,733,170,175,79,19,20,194,148,46
24031700101,Census Tract 7001.01, Montgomery County,1060,222,228,75,135,88,363,269,94
24510270200,Census Tract 2702, Baltimore city,351,84,52,34,51,38,103,111,-8
24031703220,Census Tract 7032.20, Montgomery County,1374,261,248,118,5,9,253,521,-268
24015030906,Census Tract 309.06, Cecil County,2450,409,670,314,134,75,804,562,242
24015031400,Census Tract 314, Cecil County,835,171,156,71,11,19,167,250,-83
24015031201,Census Tract 312.01, Cecil County,1475,328,350,127,13,13,363,382,-19
24015031301,Census Tract 313.01, Cecil County,815,123,84,43,46,45,130,167,-37
24031700717,Census Tract 7007.17, Montgomery County,1784,382,466,195,14,23,480,448,32
24005451402,Census Tract 4514.02, Baltimore County,1160,460,159,96,127,89,286,336,-50
24003706101,Census Tract 7061.01, Anne Arundel County,1050,236,546,173,121,74,667,689,-22
24031703202,Census Tract 7032.02, Montgomery County,1538,241,306,120,126,76,432,522,-90
24027606907,Census Tract 6069.07, Howard County,1498,380,256,148,239,201,495,658,-163
24510271600,Census Tract 2716, Baltimore city,708,274,53,40,135,86,188,346,-158
24005411309,Census Tract 4113.09, Baltimore County,2192,235,313,106,127,91,440,541,-101
24035810800,Census Tract 8108, Queen Anne's County,1480,243,283,134,146,119,429,250,179
24005400400,Census Tract 4004, Baltimore County,1502,355,338,160,157,140,495,460,35
24005402202,Census Tract 4022.02, Baltimore County,269,72,73,40,21,15,94,112,-18
24041960700,Census Tract 9607, Talbot County,556,154,31,36,21,25,52,94,-42
24031700711,Census Tract 7007.11, Montgomery County,1608,282,250,100,92,62,342,417,-75
24021772200,Census Tract 7722, Frederick County,260,105,68,47,53,46,121,112,9
24510280403,Census Tract 2804.03, Baltimore city,1173,531,266,183,18,29,284,524,-240
24031700309,Census Tract 7003.09, Montgomery County,1795,374,569,222,135,102,704,592,112
24013505203,Census Tract 5052.03, Carroll County,1012,162,156,65,87,53,243,172,71
24033800203,Census Tract 8002.03, Prince George's County,1219,240,220,77,135,65,355,378,-23
24033800206,Census Tract 8002.06, Prince George's County,1249,178,277,101,194,91,471,339,132
24033800215,Census Tract 8002.15, Prince George's County,1058,380,355,165,122,77,477,158,319
24031700615,Census Tract 7006.15, Montgomery County,910,97,111,44,69,39,180,167,13
24510280302,Census Tract 2803.02, Baltimore city,663,192,176,94,6,10,182,83,99
24005402307,Census Tract 4023.07, Baltimore County,1665,385,412,180,103,77,515,561,-46
24031701304,Census Tract 7013.04, Montgomery County,1567,210,188,98,79,58,267,296,-29
24027606904,Census Tract 6069.04, Howard County,1469,325,241,107,87,63,328,603,-275
24025301402,Census Tract 3014.02, Harford County,556,117,103,51,0,12,103,150,-47
24027601105,Census Tract 6011.05, Howard County,1571,221,317,156,108,116,425,398,27
24021773500,Census Tract 7735, Frederick County,1296,205,245,94,100,87,345,419,-74
24005451802,Census Tract 4518.02, Baltimore County,475,123,127,60,18,19,145,120,25
24510180200,Census Tract 1802, Baltimore city,189,69,70,31,23,22,93,50,43
24005451803,Census Tract 4518.03, Baltimore County,1074,187,257,90,142,58,399,434,-35
24031706005,Census Tract 7060.05, Montgomery County,1176,156,86,58,126,58,212,383,-171
24005451401,Census Tract 4514.01, Baltimore County,1424,225,343,173,148,98,491,351,140
24510130400,Census Tract 1304, Baltimore city,452,110,117,56,0,12,117,173,-56
24033800605,Census Tract 8006.05, Prince George's County,945,190,254,108,17,20,271,271,0
24033800705,Census Tract 8007.05, Prince George's County,979,214,248,98,111,74,359,256,103
24033801004,Census Tract 8010.04, Prince George's County,1350,227,243,117,73,54,316,222,94
24033801311,Census Tract 8013.11, Prince George's County,1600,371,396,194,138,100,534,550,-16
24033804400,Census Tract 8044, Prince George's County,630,111,100,36,39,16,139,199,-60
24033804900,Census Tract 8049, Prince George's County,804,246,234,91,65,63,299,562,-263
24003730700,Census Tract 7307, Anne Arundel County,1922,264,220,118,59,54,279,515,-236
24031704700,Census Tract 7047, Montgomery County,889,144,62,48,74,41,136,201,-65
24003702402,Census Tract 7024.02, Anne Arundel County,1149,259,245,123,133,91,378,281,97
24005401102,Census Tract 4011.02, Baltimore County,211,74,50,29,43,29,93,98,-5
24017850906,Census Tract 8509.06, Charles County,1398,294,271,101,142,144,413,363,50
24005403201,Census Tract 4032.01, Baltimore County,702,167,154,77,47,44,201,265,-64
24021751801,Census Tract 7518.01, Frederick County,1534,140,241,75,67,31,308,321,-13
24025303300,Census Tract 3033, Harford County,1527,309,274,128,30,34,304,428,-124
24510250206,Census Tract 2502.06, Baltimore city,561,227,135,96,0,12,135,91,44
24035810901,Census Tract 8109.01, Queen Anne's County,1404,178,299,132,84,62,383,308,75
24045010101,Census Tract 101.01, Wicomico County,1466,316,321,127,57,49,378,383,-5
24003730601,Census Tract 7306.01, Anne Arundel County,2070,259,291,169,18,29,309,346,-37
24510140100,Census Tract 1401, Baltimore city,1142,203,711,182,201,110,912,1186,-274
24025301205,Census Tract 3012.05, Harford County,896,166,135,65,111,72,246,265,-19
24510270401,Census Tract 2704.01, Baltimore city,1439,469,307,142,134,100,441,370,71
24031701316,Census Tract 7013.16, Montgomery County,1773,294,226,116,98,77,324,397,-73
24005401504,Census Tract 4015.04, Baltimore County,1515,300,404,169,91,78,495,924,-429
24005411407,Census Tract 4114.07, Baltimore County,2421,703,372,321,181,146,553,515,38
24021753001,Census Tract 7530.01, Frederick County,1024,149,272,95,0,12,272,276,-4
24033806300,Census Tract 8063, Prince George's County,667,112,140,63,63,33,203,162,41
24017851500,Census Tract 8515, Charles County,2587,482,690,252,150,108,840,809,31
24043010200,Census Tract 102, Washington County,873,152,103,63,17,19,120,248,-128
24043010100,Census Tract 101, Washington County,193,66,22,25,0,12,22,54,-32
24033804001,Census Tract 8040.01, Prince George's County,1835,452,268,159,153,125,421,486,-65
24031700824,Census Tract 7008.24, Montgomery County,825,114,76,48,36,43,112,165,-53
24043010600,Census Tract 106, Washington County,854,237,123,70,36,27,159,329,-170
24009860402,Census Tract 8604.02, Calvert County,912,203,176,72,54,44,230,275,-45
24009860900,Census Tract 8609, Calvert County,1499,242,276,106,55,52,331,330,1
24043011400,Census Tract 114, Washington County,1239,281,188,99,83,62,271,396,-125
24510140200,Census Tract 1402, Baltimore city,598,236,19,29,0,12,19,89,-70
24047951000,Census Tract 9510, Worcester County,1030,190,65,52,51,45,116,246,-130
24021752601,Census Tract 7526.01, Frederick County,1211,161,228,87,26,28,254,264,-10
24510070400,Census Tract 704, Baltimore city,458,126,22,20,164,66,186,125,61
24033807301,Census Tract 8073.01, Prince George's County,1313,212,341,144,561,215,902,590,312
24033801801,Census Tract 8018.01, Prince George's County,450,166,66,43,38,29,104,141,-37
24017850802,Census Tract 8508.02, Charles County,1508,355,410,184,58,51,468,262,206
24031701007,Census Tract 7010.07, Montgomery County,700,145,136,59,110,84,246,174,72
24510200800,Census Tract 2008, Baltimore city,739,194,187,101,10,12,197,83,114
24027602600,Census Tract 6026, Howard County,2079,245,578,165,208,140,786,687,99
24033801704,Census Tract 8017.04, Prince George's County,1327,453,249,148,121,105,370,274,96
24043011600,Census Tract 116, Washington County,664,143,138,69,19,18,157,153,4
24033803613,Census Tract 8036.13, Prince George's County,1645,334,582,207,56,52,638,606,32
24033802502,Census Tract 8025.02, Prince George's County,466,128,54,37,0,12,54,154,-100
24031705902,Census Tract 7059.02, Montgomery County,1150,193,161,75,82,50,243,207,36
24003740701,Census Tract 7407.01, Anne Arundel County,1886,255,414,149,108,78,522,590,-68
24031702700,Census Tract 7027, Montgomery County,2185,392,618,267,182,113,800,560,240
24033804102,Census Tract 8041.02, Prince George's County,1103,249,245,110,63,55,308,461,-153
24003740105,Census Tract 7401.05, Anne Arundel County,1150,253,199,87,10,17,209,300,-91
24027606706,Census Tract 6067.06, Howard County,1322,204,331,157,155,71,486,464,22
24041960400,Census Tract 9604, Talbot County,913,207,144,97,76,60,220,372,-152
24041960800,Census Tract 9608, Talbot County,425,121,62,58,0,12,62,26,36
24003730902,Census Tract 7309.02, Anne Arundel County,992,199,209,94,53,44,262,210,52
24005420301,Census Tract 4203.01, Baltimore County,628,151,84,49,30,29,114,273,-159
24005420302,Census Tract 4203.02, Baltimore County,612,147,139,76,25,28,164,99,65
24005408302,Census Tract 4083.02, Baltimore County,631,123,94,62,46,40,140,109,31
24001000200,Census Tract 2, Allegany County,493,121,73,42,7,12,80,180,-100
24510130805,Census Tract 1308.05, Baltimore city,117,44,47,31,5,8,52,70,-18
24510280301,Census Tract 2803.01, Baltimore city,789,287,176,111,177,177,353,428,-75
24019970500,Census Tract 9705, Dorchester County,999,286,104,75,26,28,130,235,-105
24510271002,Census Tract 2710.02, Baltimore city,983,291,42,40,0,12,42,282,-240
24031703215,Census Tract 7032.15, Montgomery County,956,219,157,87,89,69,246,355,-109
24035811000,Census Tract 8110, Queen Anne's County,799,226,170,136,71,53,241,228,13
24021752202,Census Tract 7522.02, Frederick County,1749,244,274,100,124,95,398,230,168
24025303602,Census Tract 3036.02, Harford County,847,127,153,69,73,44,226,180,46
24005492600,Census Tract 4926, Baltimore County,1060,267,171,76,37,30,208,473,-265
24025302901,Census Tract 3029.01, Harford County,709,191,145,66,30,32,175,111,64
24025302100,Census Tract 3021, Harford County,517,111,140,51,24,20,164,90,74
24031700614,Census Tract 7006.14, Montgomery County,1367,245,313,130,96,98,409,466,-57
24037876002,Census Tract 8760.02, St. Mary's County,3383,522,900,268,342,158,1242,806,436
24005402305,Census Tract 4023.05, Baltimore County,523,168,117,68,36,29,153,220,-67
24005980000,Census Tract 9800, Baltimore County,0,12,0,12,0,12,0,0,0
24011955400,Census Tract 9554, Caroline County,418,101,91,56,3,5,94,110,-16
24031703000,Census Tract 7030, Montgomery County,365,70,65,45,21,14,86,126,-40
24023000700,Census Tract 7, Garrett County,1210,229,178,92,57,49,235,379,-144
24510270901,Census Tract 2709.01, Baltimore city,1039,325,428,203,47,43,475,552,-77
24510040100,Census Tract 401, Baltimore city,1634,433,149,122,1178,346,1327,750,577
24035810500,Census Tract 8105, Queen Anne's County,1578,166,262,139,74,43,336,220,116
24035810200,Census Tract 8102, Queen Anne's County,514,102,34,23,26,22,60,75,-15
24510080700,Census Tract 807, Baltimore city,128,62,35,27,38,39,73,22,51
24033800604,Census Tract 8006.04, Prince George's County,438,110,119,61,29,23,148,165,-17
24021752602,Census Tract 7526.02, Frederick County,717,255,193,101,19,23,212,110,102
24021752802,Census Tract 7528.02, Frederick County,815,135,131,50,35,24,166,204,-38
24005403801,Census Tract 4038.01, Baltimore County,339,98,53,38,17,17,70,82,-12
24005441101,Census Tract 4411.01, Baltimore County,376,95,102,50,26,28,128,145,-17
24033805101,Census Tract 8051.01, Prince George's County,957,240,193,104,9,15,202,336,-134
24033805201,Census Tract 8052.01, Prince George's County,1295,277,274,117,17,25,291,259,32
24033803700,Census Tract 8037, Prince George's County,724,138,97,35,19,18,116,113,3
24033803801,Census Tract 8038.01, Prince George's County,557,103,49,32,23,21,72,166,-94
24013505208,Census Tract 5052.08, Carroll County,1019,198,151,104,31,39,182,279,-97
24013508200,Census Tract 5082, Carroll County,1863,415,397,202,163,112,560,449,111
24031703218,Census Tract 7032.18, Montgomery County,28,25,0,12,18,20,18,17,1
24013505101,Census Tract 5051.01, Carroll County,1186,165,216,80,69,50,285,395,-110
24017850101,Census Tract 8501.01, Charles County,1524,373,418,172,104,63,522,603,-81
24017851301,Census Tract 8513.01, Charles County,1479,282,322,110,66,44,388,224,164
24510250101,Census Tract 2501.01, Baltimore city,1015,268,183,116,68,59,251,318,-67
24510010100,Census Tract 101, Baltimore city,483,211,121,123,240,93,361,325,36
24009860200,Census Tract 8602, Calvert County,1727,285,376,182,63,56,439,473,-34
24009860703,Census Tract 8607.03, Calvert County,1090,222,304,123,27,27,331,252,79
24009860300,Census Tract 8603, Calvert County,1027,163,130,75,21,22,151,216,-65
24009861001,Census Tract 8610.01, Calvert County,357,100,113,49,27,24,140,103,37
24029950200,Census Tract 9502, Kent County,885,155,213,83,92,62,305,256,49
24013506200,Census Tract 5062, Carroll County,1274,241,187,90,57,39,244,339,-95
24510240200,Census Tract 2402, Baltimore city,404,154,52,49,164,100,216,138,78
24025303501,Census Tract 3035.01, Harford County,1607,316,237,102,74,61,311,272,39
24033802408,Census Tract 8024.08, Prince George's County,283,79,38,24,29,27,67,83,-16
24033802405,Census Tract 8024.05, Prince George's County,807,241,117,87,55,47,172,259,-87
24033802901,Census Tract 8029.01, Prince George's County,801,209,174,97,30,29,204,136,68
24009860600,Census Tract 8606, Calvert County,2112,350,500,180,118,96,618,547,71
24510151300,Census Tract 1513, Baltimore city,1029,286,139,71,42,51,181,161,20
24003708001,Census Tract 7080.01, Anne Arundel County,664,180,108,55,57,47,165,192,-27
24003980000,Census Tract 9800, Anne Arundel County,0,12,0,12,0,12,0,0,0
24023000100,Census Tract 1, Garrett County,667,142,96,49,65,40,161,236,-75
24023000500,Census Tract 5, Garrett County,722,177,221,84,27,27,248,162,86
24013505206,Census Tract 5052.06, Carroll County,884,106,94,62,72,41,166,178,-12
24031700812,Census Tract 7008.12, Montgomery County,948,288,203,73,31,31,234,319,-85
24510120500,Census Tract 1205, Baltimore city,501,123,130,63,123,46,253,294,-41
24017850709,Census Tract 8507.09, Charles County,1938,523,254,151,41,48,295,735,-440
24015031302,Census Tract 313.02, Cecil County,2042,266,182,75,49,38,231,397,-166
24033803525,Census Tract 8035.25, Prince George's County,631,251,171,93,35,35,206,157,49
24510272006,Census Tract 2720.06, Baltimore city,752,188,105,53,22,21,127,254,-127
24027606804,Census Tract 6068.04, Howard County,1020,191,346,116,171,67,517,369,148
24013504100,Census Tract 5041, Carroll County,1108,224,199,89,90,60,289,314,-25
24033802203,Census Tract 8022.03, Prince George's County,1023,260,108,77,24,26,132,253,-121
24013502000,Census Tract 5020, Carroll County,670,133,103,50,21,23,124,151,-27
24025303801,Census Tract 3038.01, Harford County,540,110,143,72,39,34,182,249,-67
24013507702,Census Tract 5077.02, Carroll County,646,126,190,79,34,26,224,268,-44
24013514202,Census Tract 5142.02, Carroll County,811,118,193,78,56,41,249,187,62
24013512000,Census Tract 5120, Carroll County,271,43,32,18,6,7,38,65,-27
24013510000,Census Tract 5100, Carroll County,323,100,57,36,0,12,57,53,4
24047950700,Census Tract 9507, Worcester County,486,129,57,36,37,38,94,77,17
24025303205,Census Tract 3032.05, Harford County,459,89,59,31,4,7,63,55,8
24033805904,Census Tract 8059.04, Prince George's County,924,197,242,124,129,77,371,345,26
24031701308,Census Tract 7013.08, Montgomery County,784,133,192,64,130,60,322,365,-43
24033802201,Census Tract 8022.01, Prince George's County,497,126,130,90,10,16,140,122,18
24005400500,Census Tract 4005, Baltimore County,734,95,144,49,38,22,182,213,-31
24031701702,Census Tract 7017.02, Montgomery County,867,143,428,127,89,47,517,493,24
24005440800,Census Tract 4408, Baltimore County,796,183,330,137,94,79,424,307,117
24021751702,Census Tract 7517.02, Frederick County,812,197,142,97,11,17,153,320,-167
24035990200,Census Tract 9902, Queen Anne's County,0,12,0,12,0,12,0,0,0
24005402304,Census Tract 4023.04, Baltimore County,674,253,203,78,10,16,213,242,-29
24021751302,Census Tract 7513.02, Frederick County,537,103,92,53,0,12,92,136,-44
24510200600,Census Tract 2006, Baltimore city,598,238,110,85,39,42,149,132,17
24031700608,Census Tract 7006.08, Montgomery County,1497,142,162,71,43,33,205,356,-151
24003706301,Census Tract 7063.01, Anne Arundel County,834,148,215,117,83,85,298,221,77
24003730800,Census Tract 7308, Anne Arundel County,592,106,88,50,16,12,104,144,-40
24031703212,Census Tract 7032.12, Montgomery County,2597,388,506,182,346,206,852,651,201
24003750101,Census Tract 7501.01, Anne Arundel County,921,344,237,148,32,47,269,223,46
24510160802,Census Tract 1608.02, Baltimore city,896,207,110,61,50,46,160,195,-35
24031703501,Census Tract 7035.01, Montgomery County,1484,224,334,116,83,59,417,749,-332
24031703502,Census Tract 7035.02, Montgomery County,672,213,153,124,94,74,247,193,54
24001000600,Census Tract 6, Allegany County,707,207,185,104,0,12,185,260,-75
24003740400,Census Tract 7404, Anne Arundel County,42,37,33,33,5,8,38,168,-130
24013514100,Census Tract 5141, Carroll County,954,139,158,71,89,60,247,192,55
24045000200,Census Tract 2, Wicomico County,348,112,68,41,58,37,126,135,-9
24031704300,Census Tract 7043, Montgomery County,1278,141,51,43,109,56,160,144,16
24031700304,Census Tract 7003.04, Montgomery County,2537,328,620,273,184,119,804,867,-63
24037875000,Census Tract 8750, St. Mary's County,1611,259,308,133,95,88,403,300,103
24033801005,Census Tract 8010.05, Prince George's County,1114,175,190,89,169,84,359,446,-87
24003702205,Census Tract 7022.05, Anne Arundel County,1404,276,339,158,145,102,484,371,113
24027605103,Census Tract 6051.03, Howard County,1369,174,325,102,52,37,377,353,24
24033801312,Census Tract 8013.12, Prince George's County,941,166,148,72,67,63,215,259,-44
24003731105,Census Tract 7311.05, Anne Arundel County,1211,219,182,84,140,66,322,425,-103
24005451801,Census Tract 4518.01, Baltimore County,1360,328,242,165,0,17,242,343,-101
24005411410,Census Tract 4114.10, Baltimore County,955,161,233,124,41,49,274,349,-75
24005411201,Census Tract 4112.01, Baltimore County,564,85,62,45,33,27,95,167,-72
24021751202,Census Tract 7512.02, Frederick County,1721,233,370,164,99,86,469,466,3
24003751103,Census Tract 7511.03, Anne Arundel County,1104,380,223,129,45,75,268,391,-123
24003730505,Census Tract 7305.05, Anne Arundel County,1518,269,421,169,103,72,524,587,-63
24003731202,Census Tract 7312.02, Anne Arundel County,2106,400,351,154,242,152,593,410,183
24510080600,Census Tract 806, Baltimore city,350,117,60,48,27,30,87,157,-70
24003701300,Census Tract 7013, Anne Arundel County,1995,232,335,128,0,17,335,328,7
24003731310,Census Tract 7313.10, Anne Arundel County,1259,256,269,106,32,28,301,424,-123
24021753002,Census Tract 7530.02, Frederick County,787,237,67,43,0,12,67,153,-86
24031703902,Census Tract 7039.02, Montgomery County,1819,289,218,129,154,99,372,996,-624
24033801210,Census Tract 8012.10, Prince George's County,837,187,244,134,96,60,340,214,126
24510272003,Census Tract 2720.03, Baltimore city,2102,336,471,177,150,89,621,451,170
24033803602,Census Tract 8036.02, Prince George's County,722,185,89,57,63,47,152,146,6
24043010700,Census Tract 107, Washington County,622,88,53,32,7,9,60,105,-45
24005404900,Census Tract 4049, Baltimore County,828,115,151,67,26,22,177,266,-89
24510260404,Census Tract 2604.04, Baltimore city,408,145,7,12,26,28,33,94,-61
24031704403,Census Tract 7044.03, Montgomery County,208,70,21,22,45,26,66,94,-28
24043010500,Census Tract 105, Washington County,1410,310,271,127,37,47,308,184,124
24003706302,Census Tract 7063.02, Anne Arundel County,416,140,105,58,70,50,175,180,-5
24021751004,Census Tract 7510.04, Frederick County,1112,171,329,107,153,63,482,296,186
24003731308,Census Tract 7313.08, Anne Arundel County,682,160,143,72,26,26,169,158,11
24031705200,Census Tract 7052, Montgomery County,1020,87,104,39,16,17,120,149,-29
24025301401,Census Tract 3014.01, Harford County,1592,336,440,188,127,86,567,538,29
24031703214,Census Tract 7032.14, Montgomery County,2306,324,605,219,93,68,698,1054,-356
24033800706,Census Tract 8007.06, Prince George's County,799,173,136,70,52,53,188,409,-221
24043000602,Census Tract 6.02, Washington County,616,162,77,62,43,35,120,105,15
24015030503,Census Tract 305.03, Cecil County,1430,362,319,173,121,111,440,457,-17
24033800516,Census Tract 8005.16, Prince George's County,977,185,210,90,121,69,331,425,-94
24031700722,Census Tract 7007.22, Montgomery County,1283,230,240,111,116,73,356,400,-44
24033805601,Census Tract 8056.01, Prince George's County,1450,277,91,68,0,17,91,129,-38
24033801901,Census Tract 8019.01, Prince George's County,1190,276,222,92,131,101,353,332,21
24027605402,Census Tract 6054.02, Howard County,1846,339,445,172,335,166,780,798,-18
24015030601,Census Tract 306.01, Cecil County,953,144,167,80,39,37,206,195,11
24005403401,Census Tract 4034.01, Baltimore County,455,130,49,37,55,35,104,253,-149
24021751903,Census Tract 7519.03, Frederick County,1404,192,232,117,17,28,249,312,-63
24011955000,Census Tract 9550, Caroline County,773,143,88,47,36,42,124,127,-3
24025303204,Census Tract 3032.04, Harford County,1056,117,188,73,40,25,228,289,-61
24031700830,Census Tract 7008.30, Montgomery County,920,220,347,135,136,88,483,330,153
24031704404,Census Tract 7044.04, Montgomery County,1286,254,83,86,121,72,204,333,-129
24005410100,Census Tract 4101, Baltimore County,1582,221,127,80,144,84,271,393,-122
24005430600,Census Tract 4306, Baltimore County,521,113,165,100,39,32,204,144,60
24021752603,Census Tract 7526.03, Frederick County,1094,127,120,53,52,37,172,221,-49
24003702204,Census Tract 7022.04, Anne Arundel County,1222,138,206,76,69,44,275,431,-156
24033804200,Census Tract 8042, Prince George's County,563,120,76,49,55,51,131,275,-144
24031703301,Census Tract 7033.01, Montgomery County,1557,240,329,114,85,69,414,352,62
24031700715,Census Tract 7007.15, Montgomery County,1990,413,516,200,211,105,727,682,45
24510271300,Census Tract 2713, Baltimore city,577,111,85,39,48,59,133,319,-186
24031703901,Census Tract 7039.01, Montgomery County,888,142,213,92,56,35,269,255,14
24033804300,Census Tract 8043, Prince George's County,939,210,135,83,17,26,152,147,5
24031700713,Census Tract 7007.13, Montgomery County,1733,357,332,111,143,119,475,712,-237
24031705400,Census Tract 7054, Montgomery County,902,61,89,34,26,20,115,60,55
24021750503,Census Tract 7505.03, Frederick County,2565,510,650,294,241,200,891,403,488
24045000400,Census Tract 4, Wicomico County,1228,392,629,357,27,29,656,906,-250
24033800411,Census Tract 8004.11, Prince George's County,1168,228,213,101,204,126,417,364,53
24025301202,Census Tract 3012.02, Harford County,2106,294,401,166,136,81,537,481,56
24033801807,Census Tract 8018.07, Prince George's County,992,293,178,96,60,52,238,379,-141
24019970600,Census Tract 9706, Dorchester County,1119,254,254,120,57,47,311,327,-16
24033803508,Census Tract 8035.08, Prince George's County,1422,291,254,104,91,60,345,243,102
24005404600,Census Tract 4046, Baltimore County,540,144,49,30,20,23,69,128,-59
24031700823,Census Tract 7008.23, Montgomery County,844,206,173,66,108,80,281,240,41
24035810100,Census Tract 8101, Queen Anne's County,759,208,38,48,56,49,94,47,47
24029950400,Census Tract 9504, Kent County,630,216,52,45,18,17,70,71,-1
24001001000,Census Tract 10, Allegany County,484,119,101,70,21,29,122,164,-42
24033803509,Census Tract 8035.09, Prince George's County,959,140,261,75,47,54,308,305,3
24005490900,Census Tract 4909, Baltimore County,953,454,597,410,179,167,776,590,186
24025301102,Census Tract 3011.02, Harford County,993,165,201,86,24,26,225,215,10
24021751802,Census Tract 7518.02, Frederick County,705,138,46,36,13,20,59,338,-279
24027602202,Census Tract 6022.02, Howard County,1735,202,232,104,87,59,319,443,-124
24510250204,Census Tract 2502.04, Baltimore city,1894,331,144,83,14,21,158,189,-31
24031703207,Census Tract 7032.07, Montgomery County,2114,337,493,175,23,26,516,316,200
24045000300,Census Tract 3, Wicomico County,360,108,63,55,0,12,63,125,-62
24041960100,Census Tract 9601, Talbot County,779,135,131,76,47,39,178,210,-32
24025302801,Census Tract 3028.01, Harford County,849,201,284,83,28,39,312,314,-2
24510090200,Census Tract 902, Baltimore city,584,230,190,98,60,62,250,312,-62
24510270702,Census Tract 2707.02, Baltimore city,450,147,116,46,86,67,202,117,85
24033803900,Census Tract 8039, Prince George's County,938,145,192,83,8,13,200,138,62
24009860401,Census Tract 8604.01, Calvert County,2650,306,477,170,138,78,615,807,-192
24009860502,Census Tract 8605.02, Calvert County,622,119,101,69,0,12,101,219,-118
24033806714,Census Tract 8067.14, Prince George's County,1501,276,429,143,127,64,556,330,226
24041960900,Census Tract 9609, Talbot County,620,120,112,56,10,11,122,203,-81
24510100200,Census Tract 1002, Baltimore city,745,230,45,53,0,12,45,102,-57
24005402302,Census Tract 4023.02, Baltimore County,1631,284,428,129,119,66,547,471,76
24031701101,Census Tract 7011.01, Montgomery County,1120,178,196,72,34,39,230,344,-114
24033800403,Census Tract 8004.03, Prince George's County,985,161,205,77,115,49,320,356,-36
24031700607,Census Tract 7006.07, Montgomery County,2248,288,389,174,167,114,556,698,-142
24005402407,Census Tract 4024.07, Baltimore County,329,81,82,48,23,28,105,128,-23
24031701415,Census Tract 7014.15, Montgomery County,1922,260,539,189,123,89,662,582,80
24011955202,Census Tract 9552.02, Caroline County,330,82,54,41,10,12,64,84,-20
24011955301,Census Tract 9553.01, Caroline County,1132,148,222,109,58,40,280,167,113
24025304101,Census Tract 3041.01, Harford County,904,193,151,71,84,64,235,222,13
24025305100,Census Tract 3051, Harford County,1965,328,435,167,14,23,449,619,-170
24013507500,Census Tract 5075, Carroll County,2387,279,1460,232,87,73,1547,1476,71
24037875201,Census Tract 8752.01, St. Mary's County,1441,180,178,81,87,49,265,359,-94
24005451200,Census Tract 4512, Baltimore County,720,142,166,67,116,83,282,220,62
24031702102,Census Tract 7021.02, Montgomery County,1139,110,166,57,43,35,209,144,65
24013507704,Census Tract 5077.04, Carroll County,1729,285,308,128,197,124,505,409,96
24033802700,Census Tract 8027, Prince George's County,718,143,174,86,44,35,218,105,113
24005450200,Census Tract 4502, Baltimore County,723,180,162,119,31,31,193,207,-14
24013504201,Census Tract 5042.01, Carroll County,1552,271,237,87,79,75,316,408,-92
24001002200,Census Tract 22, Allegany County,609,137,104,56,12,20,116,111,5
24031701221,Census Tract 7012.21, Montgomery County,1400,228,228,129,74,53,302,342,-40
24005401400,Census Tract 4014, Baltimore County,422,100,86,56,11,11,97,85,12
24029950100,Census Tract 9501, Kent County,693,121,40,25,28,24,68,159,-91
24003750400,Census Tract 7504, Anne Arundel County,707,146,117,83,79,62,196,232,-36
24031700206,Census Tract 7002.06, Montgomery County,1626,164,307,90,125,64,432,482,-50
24033801216,Census Tract 8012.16, Prince George's County,1048,245,275,140,101,67,376,259,117
24015030904,Census Tract 309.04, Cecil County,1917,339,149,78,30,37,179,328,-149
24031700829,Census Tract 7008.29, Montgomery County,688,148,119,66,49,43,168,166,2
24031701201,Census Tract 7012.01, Montgomery County,1592,400,411,181,115,79,526,627,-101
24003731309,Census Tract 7313.09, Anne Arundel County,1518,312,392,169,17,28,409,404,5
24033800519,Census Tract 8005.19, Prince George's County,1152,209,172,81,106,64,278,473,-195
24003731103,Census Tract 7311.03, Anne Arundel County,1767,275,280,82,164,84,444,414,30
24033801212,Census Tract 8012.12, Prince George's County,658,237,99,66,15,21,114,223,-109
24031702200,Census Tract 7022, Montgomery County,1135,189,92,63,84,54,176,241,-65
24015030905,Census Tract 309.05, Cecil County,469,148,67,51,14,21,81,80,1
24043010900,Census Tract 109, Washington County,2339,356,492,170,165,92,657,689,-32
24510130806,Census Tract 1308.06, Baltimore city,263,106,21,19,69,40,90,57,33
24510160600,Census Tract 1606, Baltimore city,954,268,317,206,14,21,331,184,147
24017850202,Census Tract 8502.02, Charles County,1247,198,88,60,74,62,162,271,-109
24005490400,Census Tract 4904, Baltimore County,409,64,37,27,17,18,54,102,-48
24045010605,Census Tract 106.05, Wicomico County,1205,212,360,171,19,22,379,197,182
24033801003,Census Tract 8010.03, Prince George's County,1505,272,320,161,128,74,448,487,-39
24043011100,Census Tract 111, Washington County,1400,332,440,254,29,30,469,518,-49
24001000500,Census Tract 5, Allegany County,746,186,579,176,16,18,595,306,289
24027602201,Census Tract 6022.01, Howard County,1137,129,174,84,37,46,211,340,-129
24027605104,Census Tract 6051.04, Howard County,1738,158,234,74,112,61,346,414,-68
24033802407,Census Tract 8024.07, Prince George's County,519,155,109,69,24,39,133,233,-100
24003730901,Census Tract 7309.01, Anne Arundel County,821,139,162,69,43,26,205,227,-22
24003702601,Census Tract 7026.01, Anne Arundel County,1238,261,133,94,183,169,316,311,5
24033800102,Census Tract 8001.02, Prince George's County,469,132,104,102,84,58,188,218,-30
24033803513,Census Tract 8035.13, Prince George's County,1059,207,370,161,59,56,429,577,-148
24037875500,Census Tract 8755, St. Mary's County,3746,395,366,127,288,124,654,414,240
24023000200,Census Tract 2, Garrett County,935,173,113,53,40,35,153,115,38
24033800212,Census Tract 8002.12, Prince George's County,1231,283,304,159,317,132,621,728,-107
24013508101,Census Tract 5081.01, Carroll County,1191,319,224,78,62,44,286,354,-68
24001001700,Census Tract 17, Allegany County,1563,313,755,305,109,84,864,683,181
24510272005,Census Tract 2720.05, Baltimore city,1119,258,288,241,62,37,350,403,-53
24005420402,Census Tract 4204.02, Baltimore County,432,96,65,35,6,9,71,248,-177
24027605503,Census Tract 6055.03, Howard County,1533,456,393,210,114,100,507,575,-68
24031701503,Census Tract 7015.03, Montgomery County,1213,307,353,201,26,31,379,653,-274
24031701303,Census Tract 7013.03, Montgomery County,884,156,198,105,45,27,243,267,-24
24510130700,Census Tract 1307, Baltimore city,765,175,161,110,275,103,436,478,-42
24005408303,Census Tract 4083.03, Baltimore County,847,131,81,48,28,29,109,266,-157
24005451600,Census Tract 4516, Baltimore County,345,93,69,36,29,23,98,90,8
24510270802,Census Tract 2708.02, Baltimore city,1252,396,187,119,23,37,210,433,-223
24005408502,Census Tract 4085.02, Baltimore County,849,172,88,58,52,49,140,325,-185
24031701409,Census Tract 7014.09, Montgomery County,1121,184,292,132,95,51,387,428,-41
24031704502,Census Tract 7045.02, Montgomery County,808,88,89,47,30,18,119,111,8
24045010400,Census Tract 104, Wicomico County,2935,521,2319,445,93,65,2412,2263,149
24017850600,Census Tract 8506, Charles County,1285,254,243,102,57,45,300,376,-76
24021751600,Census Tract 7516, Frederick County,706,146,109,48,26,30,135,197,-62
24033800505,Census Tract 8005.05, Prince George's County,549,119,124,69,72,35,196,235,-39
24510080500,Census Tract 805, Baltimore city,369,167,48,43,0,12,48,114,-66
24005402504,Census Tract 4025.04, Baltimore County,1569,295,417,139,102,77,519,368,151
24005402405,Census Tract 4024.05, Baltimore County,1046,243,263,106,102,96,365,326,39
24510270803,Census Tract 2708.03, Baltimore city,1784,481,373,198,351,254,724,926,-202
24003706402,Census Tract 7064.02, Anne Arundel County,843,204,153,104,64,39,217,146,71
24003730100,Census Tract 7301, Anne Arundel County,2832,461,740,297,154,135,894,571,323
24033804101,Census Tract 8041.01, Prince George's County,723,194,96,83,71,64,167,330,-163
24510240400,Census Tract 2404, Baltimore city,536,153,29,29,281,143,310,228,82
24031703800,Census Tract 7038, Montgomery County,931,226,230,94,241,110,471,248,223
24033800800,Census Tract 8008, Prince George's County,565,156,157,95,47,33,204,190,14
24510090400,Census Tract 904, Baltimore city,375,115,34,35,13,16,47,58,-11
24009860802,Census Tract 8608.02, Calvert County,954,200,132,64,24,24,156,330,-174
24003731104,Census Tract 7311.04, Anne Arundel County,1208,168,230,94,59,41,289,398,-109
24033803606,Census Tract 8036.06, Prince George's County,1886,287,475,150,171,108,646,543,103
24043001002,Census Tract 10.02, Washington County,934,149,182,79,37,34,219,206,13
24001001503,Census Tract 15.03, Allegany County,255,72,40,25,0,12,40,74,-34
24003740305,Census Tract 7403.05, Anne Arundel County,4224,510,753,294,248,145,1001,1308,-307
24031703201,Census Tract 7032.01, Montgomery County,1829,380,384,159,19,26,403,625,-222
24035810600,Census Tract 8106, Queen Anne's County,1031,141,206,77,61,41,267,293,-26
24033803521,Census Tract 8035.21, Prince George's County,1989,360,445,191,168,105,613,431,182
24025303502,Census Tract 3035.02, Harford County,934,117,267,74,120,50,387,382,5
24021752101,Census Tract 7521.01, Frederick County,807,119,181,83,39,35,220,311,-91
24043010300,Census Tract 103, Washington County,1693,279,261,107,93,68,354,374,-20
24033802204,Census Tract 8022.04, Prince George's County,1118,265,301,171,58,47,359,422,-63
24047951300,Census Tract 9513, Worcester County,554,106,104,67,0,12,104,184,-80
24031706010,Census Tract 7060.10, Montgomery County,730,140,111,58,39,32,150,201,-51
24031700813,Census Tract 7008.13, Montgomery County,1484,259,322,144,141,85,463,481,-18
24043000601,Census Tract 6.01, Washington County,376,105,62,32,44,37,106,125,-19
24027602900,Census Tract 6029, Howard County,1039,180,183,95,53,44,236,292,-56
24033802501,Census Tract 8025.01, Prince George's County,506,184,87,56,22,24,109,113,-4
24025302200,Census Tract 3022, Harford County,690,168,79,58,15,16,94,156,-62
24510130300,Census Tract 1303, Baltimore city,593,183,27,21,4,6,31,66,-35
24021752204,Census Tract 7522.04, Frederick County,3151,324,363,151,167,104,530,411,119
24017850706,Census Tract 8507.06, Charles County,1694,273,342,127,95,59,437,284,153
24005400702,Census Tract 4007.02, Baltimore County,571,126,113,44,73,41,186,220,-34
24021767600,Census Tract 7676, Frederick County,670,93,112,50,6,8,118,201,-83
24031706011,Census Tract 7060.11, Montgomery County,1548,171,247,93,113,65,360,278,82
24027604001,Census Tract 6040.01, Howard County,2085,499,277,124,163,135,440,470,-30
24043000302,Census Tract 3.02, Washington County,666,174,71,48,12,20,83,91,-8
24017850708,Census Tract 8507.08, Charles County,1275,226,291,95,122,81,413,374,39
24003740702,Census Tract 7407.02, Anne Arundel County,2404,356,196,110,177,101,373,667,-294
24031702602,Census Tract 7026.02, Montgomery County,1451,492,359,196,492,278,851,878,-27
24005402603,Census Tract 4026.03, Baltimore County,1779,382,468,194,353,207,821,708,113
24005440600,Census Tract 4406, Baltimore County,567,78,163,42,35,25,198,139,59
24009860701,Census Tract 8607.01, Calvert County,775,191,262,107,31,35,293,218,75
24510090900,Census Tract 909, Baltimore city,1037,398,138,99,16,27,154,136,18
24510170100,Census Tract 1701, Baltimore city,315,98,96,59,69,33,165,102,63
24019970400,Census Tract 9704, Dorchester County,724,236,86,68,63,42,149,236,-87
24510090100,Census Tract 901, Baltimore city,804,232,215,110,27,23,242,300,-58
24027606901,Census Tract 6069.01, Howard County,1583,342,427,178,197,117,624,408,216
24003702300,Census Tract 7023, Anne Arundel County,1431,227,197,81,51,39,248,272,-24
24510010500,Census Tract 105, Baltimore city,420,122,5,8,219,72,224,221,3
24015030506,Census Tract 305.06, Cecil County,1995,393,443,157,202,151,645,804,-159
24025301204,Census Tract 3012.04, Harford County,826,143,146,79,64,43,210,237,-27
24031700816,Census Tract 7008.16, Montgomery County,2227,310,455,181,110,86,565,786,-221
24003702100,Census Tract 7021, Anne Arundel County,1262,273,281,128,37,44,318,221,97
24003730504,Census Tract 7305.04, Anne Arundel County,1665,427,203,102,238,154,441,490,-49
24037875100,Census Tract 8751, St. Mary's County,1472,337,249,127,161,91,410,304,106
24003751200,Census Tract 7512, Anne Arundel County,1159,302,285,122,119,129,404,442,-38
24025304102,Census Tract 3041.02, Harford County,967,174,137,76,47,38,184,186,-2
24003702208,Census Tract 7022.08, Anne Arundel County,2040,348,190,117,202,99,392,274,118
24005402201,Census Tract 4022.01, Baltimore County,883,296,293,95,13,31,306,377,-71
24025303803,Census Tract 3038.03, Harford County,1275,312,386,169,89,70,475,451,24
24033806100,Census Tract 8061, Prince George's County,993,169,122,75,117,67,239,401,-162
24027601104,Census Tract 6011.04, Howard County,2340,185,404,117,73,49,477,490,-13
24005451900,Census Tract 4519, Baltimore County,710,144,100,50,5,9,105,124,-19
24027606603,Census Tract 6066.03, Howard County,2561,472,680,213,131,93,811,952,-141
24033803610,Census Tract 8036.10, Prince George's County,900,216,318,104,61,46,379,242,137
24017850201,Census Tract 8502.01, Charles County,199,88,83,61,24,23,107,102,5
24031700716,Census Tract 7007.16, Montgomery County,2224,431,484,204,225,135,709,898,-189
24003750201,Census Tract 7502.01, Anne Arundel County,484,248,174,121,20,24,194,150,44
24033806713,Census Tract 8067.13, Prince George's County,1540,309,464,156,62,57,526,489,37
24001000400,Census Tract 4, Allegany County,634,202,99,87,23,35,122,149,-27
24013503000,Census Tract 5030, Carroll County,1560,347,390,145,11,18,401,372,29
24510151200,Census Tract 1512, Baltimore city,751,249,103,65,39,47,142,231,-89
24009861003,Census Tract 8610.03, Calvert County,1252,246,80,63,45,64,125,538,-413
24031703209,Census Tract 7032.09, Montgomery County,1833,385,378,243,160,121,538,535,3
24003740603,Census Tract 7406.03, Anne Arundel County,762,253,462,232,21,19,483,700,-217
24510130200,Census Tract 1302, Baltimore city,783,315,191,97,50,63,241,296,-55
24015030501,Census Tract 305.01, Cecil County,940,177,112,60,43,39,155,165,-10
24031704501,Census Tract 7045.01, Montgomery County,872,155,112,72,41,36,153,209,-56
24013505205,Census Tract 5052.05, Carroll County,831,142,116,57,54,35,170,303,-133
24021752801,Census Tract 7528.01, Frederick County,439,73,103,56,27,24,130,136,-6
24005402306,Census Tract 4023.06, Baltimore County,1225,205,205,116,123,68,328,370,-42
24003702702,Census Tract 7027.02, Anne Arundel County,790,155,118,63,36,29,154,158,-4
24001001600,Census Tract 16, Allegany County,444,109,132,78,34,24,166,187,-21
24031701800,Census Tract 7018, Montgomery County,1352,177,180,107,144,84,324,527,-203
24027605505,Census Tract 6055.05, Howard County,2039,231,306,95,109,67,415,400,15
24033800707,Census Tract 8007.07, Prince George's County,610,132,152,86,50,43,202,280,-78
24031700818,Census Tract 7008.18, Montgomery County,2416,602,601,182,135,92,736,866,-130
24510150800,Census Tract 1508, Baltimore city,788,248,149,116,25,38,174,138,36
24031703702,Census Tract 7037.02, Montgomery County,856,194,223,125,89,50,312,390,-78
24510160400,Census Tract 1604, Baltimore city,670,275,43,40,0,12,43,79,-36
24033801208,Census Tract 8012.08, Prince George's County,1207,231,246,95,98,58,344,280,64
24033800900,Census Tract 8009, Prince George's County,308,73,61,40,4,6,65,120,-55
24021752102,Census Tract 7521.02, Frederick County,1285,205,251,154,29,37,280,214,66
24005402403,Census Tract 4024.03, Baltimore County,460,137,111,52,56,49,167,251,-84
24027606701,Census Tract 6067.01, Howard County,707,138,80,39,67,41,147,181,-34
24037875400,Census Tract 8754, St. Mary's County,1904,283,313,149,154,122,467,600,-133
24005450300,Census Tract 4503, Baltimore County,512,158,89,51,0,12,89,114,-25
24021752501,Census Tract 7525.01, Frederick County,1080,152,211,59,41,33,252,383,-131
24031704100,Census Tract 7041, Montgomery County,1296,179,161,57,103,64,264,206,58
24025303802,Census Tract 3038.02, Harford County,424,84,106,49,28,22,134,156,-22
24005402503,Census Tract 4025.03, Baltimore County,1264,328,300,176,146,93,446,559,-113
24043000700,Census Tract 7, Washington County,867,244,92,76,0,12,92,189,-97
24005430800,Census Tract 4308, Baltimore County,906,218,350,132,60,50,410,254,156
24013513002,Census Tract 5130.02, Carroll County,1699,223,249,89,133,74,382,380,2
24003751500,Census Tract 7515, Anne Arundel County,1663,425,51,56,46,77,97,215,-118
24045010702,Census Tract 107.02, Wicomico County,2045,402,323,139,66,40,389,574,-185
24033802103,Census Tract 8021.03, Prince George's County,1068,202,141,86,153,82,294,279,15
24005403702,Census Tract 4037.02, Baltimore County,1578,311,454,174,149,116,603,1023,-420
24033802301,Census Tract 8023.01, Prince George's County,786,217,105,59,20,23,125,290,-165
24023000600,Census Tract 6, Garrett County,1021,260,105,60,117,123,222,297,-75
24031700610,Census Tract 7006.10, Montgomery County,584,90,146,52,21,18,167,166,1
24033801405,Census Tract 8014.05, Prince George's County,751,219,173,65,55,67,228,173,55
24013507602,Census Tract 5076.02, Carroll County,782,105,146,77,34,25,180,262,-82
24027601103,Census Tract 6011.03, Howard County,1575,267,234,98,154,96,388,435,-47
24025303206,Census Tract 3032.06, Harford County,946,109,137,69,14,17,151,143,8
24033802104,Census Tract 8021.04, Prince George's County,286,111,44,38,5,8,49,72,-23
24003731306,Census Tract 7313.06, Anne Arundel County,1528,273,476,183,110,89,586,734,-148
24009861004,Census Tract 8610.04, Calvert County,1996,365,328,190,58,61,386,451,-65
24005408505,Census Tract 4085.05, Baltimore County,846,162,153,88,37,29,190,418,-228
24021752900,Census Tract 7529, Frederick County,675,157,153,81,14,21,167,204,-37
24510280401,Census Tract 2804.01, Baltimore city,731,227,181,90,113,136,294,237,57
24003702500,Census Tract 7025, Anne Arundel County,1725,609,325,231,13,21,338,266,72
24031701507,Census Tract 7015.07, Montgomery County,1204,164,249,107,160,75,409,278,131
24005401507,Census Tract 4015.07, Baltimore County,1895,339,329,129,167,112,496,489,7
24033805202,Census Tract 8052.02, Prince George's County,1002,263,206,101,73,67,279,404,-125
24005400800,Census Tract 4008, Baltimore County,831,224,119,78,74,52,193,149,44
24510260700,Census Tract 2607, Baltimore city,614,178,79,51,74,45,153,78,75
24031705800,Census Tract 7058, Montgomery County,2069,247,112,68,169,110,281,240,41
24031700312,Census Tract 7003.12, Montgomery County,2139,428,350,111,100,73,450,448,2
24025302902,Census Tract 3029.02, Harford County,745,252,114,70,0,12,114,227,-113
24510150701,Census Tract 1507.01, Baltimore city,275,110,86,51,0,12,86,101,-15
24031700704,Census Tract 7007.04, Montgomery County,656,105,166,58,101,46,267,279,-12
24025301703,Census Tract 3017.03, Harford County,1214,213,214,90,185,103,399,358,41
24005451702,Census Tract 4517.02, Baltimore County,381,87,47,44,40,31,87,131,-44
24021752302,Census Tract 7523.02, Frederick County,1024,155,210,102,77,63,287,226,61
24033801409,Census Tract 8014.09, Prince George's County,681,189,88,65,50,47,138,147,-9
24033802805,Census Tract 8028.05, Prince George's County,1143,205,209,84,82,61,291,287,4
24031700815,Census Tract 7008.15, Montgomery County,2006,413,187,127,73,80,260,474,-214
24005404201,Census Tract 4042.01, Baltimore County,1626,249,335,150,121,105,456,542,-86
24005404404,Census Tract 4044.04, Baltimore County,1196,257,199,66,82,46,281,291,-10
24005403601,Census Tract 4036.01, Baltimore County,1044,180,138,81,112,107,250,279,-29
24005430300,Census Tract 4303, Baltimore County,1648,327,232,126,101,63,333,178,155
24025304201,Census Tract 3042.01, Harford County,1609,227,264,141,127,101,391,254,137
24033801808,Census Tract 8018.08, Prince George's County,1165,301,196,85,34,33,230,197,33
24031705502,Census Tract 7055.02, Montgomery County,981,123,36,26,36,25,72,136,-64
24027606604,Census Tract 6066.04, Howard County,1289,234,283,100,95,57,378,452,-74
24003751000,Census Tract 7510, Anne Arundel County,828,280,103,55,30,28,133,275,-142
24011955500,Census Tract 9555, Caroline County,784,133,92,55,29,27,121,215,-94
24037875902,Census Tract 8759.02, St. Mary's County,2412,459,323,163,235,150,558,455,103
24021751902,Census Tract 7519.02, Frederick County,1736,237,234,125,113,66,347,284,63
24005452400,Census Tract 4524, Baltimore County,782,160,172,84,64,45,236,241,-5
24005405000,Census Tract 4050, Baltimore County,1009,153,245,80,129,65,374,275,99
24011955100,Census Tract 9551, Caroline County,1734,224,322,133,40,37,362,135,227
24510250500,Census Tract 2505, Baltimore city,625,274,116,117,39,40,155,338,-183
24015030200,Census Tract 302, Cecil County,1169,218,195,142,52,60,247,336,-89
24033803520,Census Tract 8035.20, Prince George's County,1170,252,302,116,198,108,500,334,166
24035990000,Census Tract 9900, Queen Anne's County,0,12,0,12,0,12,0,0,0
24035990100,Census Tract 9901, Queen Anne's County,0,12,0,12,0,12,0,0,0
24019990000,Census Tract 9900, Dorchester County,0,12,0,12,0,12,0,0,0
24037990000,Census Tract 9900, St. Mary's County,0,12,0,12,0,12,0,0,0
24039990100,Census Tract 9901, Somerset County,0,12,0,12,0,12,0,0,0
24041990000,Census Tract 9900, Talbot County,0,12,0,12,0,12,0,0,0
24047990000,Census Tract 9900, Worcester County,0,12,0,12,0,12,0,0,0
24003990000,Census Tract 9900, Anne Arundel County,0,12,0,12,0,12,0,0,0
24009990100,Census Tract 9901, Calvert County,0,12,0,12,0,12,0,0,0
24029990000,Census Tract 9900, Kent County,0,12,0,12,0,12,0,0,0
